Textures/town1.bmp
10 7
6 11
0
 307000070000702 
 1 1    1    1 1 
 80:0000:0000:09 
 1 1    1    1 1 
 805    1    409 
 1   C  1 J    1 
 1F     1    F 1 
 800007060700009 
 1    1   1    1 
 1    1   1    1 
 1 I  1B  1 L  1 
 800006070600009 
 1      1      1 
 1G     1    G 1 
 802 J  1 K  309 
 1 1    1    1 1 
 80:0000:0000:09 
 1 1    1    1 1 
 406000060000605 
*
  5 111 11111111> 111111111 116   
                                  
  1   1         1         1   1   
  1   1         1         1   1   
  1 111 111111111 111111111 111   
                                  
  1   1         1         1   1   
  1   1         1         1   1   
  1 112         1         2 111   
                1                 
  1             1             1   
  1             1             1   
  1             1             1   
  1             1             1   
  1 11111111          111111111   
                                  
  1                           1   
  1                           1   
  1                           1   
  1                           1   
  1                           1   
  1                           1   
  1 11111111          111111111   
                                  
  1             1             1   
  1             1             1   
  1             1             1   
  1             1             1   
  1 112         1         2 111   
                1                 
  1   1         1         1   1   
  1   1         1         1   1   
  1 111 111111111 111111111 111   
                                  
  1   1         1         1   1   
  1   1         1         1   1   
  6 111 11111111> 111111111 115   
                                  
*