Textures/desert1.bmp
10 7
7 7
1
300070070070070002
1   1  1  1  1   1
1   1  1  1  1   1
1D  1  1C 1  1D  1
80076009  80067009
1  1   1  1   1  1
1  1   1  1   1A 1
80067009  80076009
1   1  1B 1  1   1
1B  1  1  1  1   1
4070600:00:0060705
  1    1  1    1  
  1A   1  1 B  1  
  800009  800009  
  1    1  1    1  
  1 C  1  1    1  
  40000600600005  
*
2 1111111 11111 11111 11111 1111112 
                                    
1       1     1     1     1       1 
1       1     1     1     1       1 
1       1     1     1     1       1 
1       1     1     1     1       1 
1       1     1     1     1       1 
1       1     1     1     1       1 
1 11111 1 1111:     : 11111 1 11111 
                                    
1     1       1     1       1     1 
1     1       1     1       1     1 
1     1       1     1       1     1 
1     1       1     1       1     1 
1 11111 1 11111     1 11111 1 11111 
                                    
1       1     1     1     1       1 
1       1     1     1     1       1 
1       1     1     1     1       1 
1       1     1     1     1       1 
1 112 111 11111 11111 11111 112 111 
                                    
    1         1     1         1     
    1         1     1         1     
    1         1     1         1     
    1         1     1         1     
    1 111111111     1 111111111     
                                    
    1         1     1         1     
    1         1     1         1     
    1         1     1         1     
    1         1     1         1     
    3 111111111 11111 111111113     
                                    
*