Textures/garden3.bmp
13 3
13 11
1
300007000000070002
1    1       1   1
1    1B    B 1   1
1  30:000000762F 1
1  1 1      1 8009
8009 1F   E 475  1
1  1 1       1 C 1
1\ 1 1       1   1
8009 1  D    1   1
1  1 1      362  1
1  1 1G   H 1 8009
1G 40:000000675  1
1    1       1 B 1
1H E 1C D  C 1   1
400006000000060005
*
2 111111111 111111111111111 1111112 
                                    
1         1               1       1 
1         1               1       1 
1         1               1       1 
1         1                       1 
1     1 111 111111111111          1 
1                                 1 
1     1   1                   11111 
1     1   1                         
1 1111>   1                       1 
          1                       1 
1     1   1               1       1 
1     1   1               1       1 
1     1   1               1       1 
1     1   1               1       1 
1 1111<   1               1       1 
          1               1       1 
1     1   1                       1 
1     1   1                       1 
1     1   1                   11111 
1     1   1                         
1     1 111 111111111111          1 
1                                 1 
1         1               1       1 
1         1               1       1 
1         1               1       1 
1         1               1       1 
2 111111111 111111111111111 1111112 
                                    
*