Textures/classic9.bmp
10 10
6 8
1
                  
3002         3002 
1  1         1  1 
1 3600700070062 1 
809   1   1   809 
1 1 3062 3602 1 1 
1 1 1  1 1  1 1 1 
40:09 36062 80:05 
  1 409   805 1   
  1   1   1   1   
  1 309   802 1   
30:09 47075 80:02 
1 1 1  1 1  1 1 1 
1 1 4075 4705 1 1 
809   1   1   809 
1 4700600060075 1 
1  1         1  1 
4005         4005 
*
                                    
                                    
2 11111                   1 11112   
                                    
1     1                   1     1   
1     1                   1     1   
1   3 1 11111 1111111 11111 :   1   
1                               1   
1 111       1       1       1 111   
            1       1               
1   1   5 111 1   1 1 114   1   1   
1   1                       1   1   
1   1   1     1   1     1   1   1   
1   1   1     1   1     1   1   1   
1 111 111               1 111 111   
                                    
    1   1 11          111   1       
    1                       1       
    1                       1       
    1                       1       
    1   1 11          111   1       
    1                       1       
1 111 111               1 111 111   
                                    
1   1   1     1   1     1   1   1   
1   1   1     1   1     1   1   1   
1   1   4 111 1   1 1 115   1   1   
1   1                       1   1   
1 111       1       1       1 111   
            1       1               
1   > 1 11111 1111111 11111 3   1   
1                               1   
1     1                   1     1   
1     1                   1     1   
2 11111                   1 11112   
                                    
*