Textures/classic2.bmp
11 5
7 5
1
300007000700000002
1    1   1       1
8002 1 30602     1
1  1 1 1   1 30009
1  1 1 1   1 1   1
8076060:000:060009
1 1    1   1     1
1 1    1   1  3009
1 402  40705  1  1
1   1    1    1  1
400060000600006005
*
2 111111111 1111111 111111111111112 
                                    
1         1       1               1 
1         1       1               1 
1 1111>   1   1 111 111           1 
          1                       1 
1     1   1               1 1111111 
1     1   1                         
1     1   1               1       1 
1     1   1               1       1 
1 111 1 111               1 1111111 
                                    
1   1                             1 
1   1                             1 
1   1                       6 11111 
1   1                               
1   3 111     1 111 111     1     1 
1                           1     1 
1       1         1         1     1 
1       1         1         1     1 
2 1111111 111111111 111111111 11112 
                                    
*