Textures/town2.bmp
9 7
9 21
1
   3007007007002  
   1  1  1  1  1  
   1F 1E 1G 1F 1  
   8005  1  4009  
   1     1     1  
   1     1   E 1  
   1 J   1 L   1  
   800700:007009  
   1  1  1  1  1  
   1E 1H 1H 1E 1  
   8005  1  4009  
   1     1     1  
   80002 1 30009  
   1   1 1 1   1  
   1   80:09   1  
   1B  1 1 1K  1  
   80005 1 40009  
   1     1     1  
   8002  1  3009  
   1  1  1  1  1  
   1G 1  1  1G 1  
   800600:006009  
   1     1     1  
   1     1     1  
   1 I   1 C   1  
   8002  1  3009  
   1  1  1  1  1  
   1F 1  1  1F 1  
   4006006006005  
                  
*
      3 11111 11111 11111 11113     
                                    
      1     1           1     1     
      1     1           1     1     
      1     1           1     1     
      1     1           1     1     
      1 11112           2 11111     
                                    
      1                       1     
      1                       1     
      1                       1     
      1                       1     
      1                       1     
      1                       1     
      > 11111 1111  11111 1111<     
                                    
      1     1           1     1     
      1     1           1     1     
      1     1           1     1     
      1     1           1     1     
      1 11114           5 11111     
                                    
      1                       1     
      1                       1     
      1 1111111       1 1111111     
                                    
      1       1       1       1     
      1       1       1       1     
      1       1 11; 111       1     
      1                       1     
      1       1       1       1     
      1       1       1       1     
      1 1111111       1 1111111     
                                    
      1                       1     
      1                       1     
      1 11115           4 11111     
                                    
      1     1           1     1     
      1     1           1     1     
      1     1           1     1     
      1     1           1     1     
      1 11111           1 11111     
                                    
      1                       1     
      1                       1     
      1                       1     
      1                       1     
      1                       1     
      1                       1     
      1 11112           2 11111     
                                    
      1     1           1     1     
      1     1           1     1     
      1     1           1     1     
      1     1           1     1     
      3 11111 11111 11111 11113     
                                    
                                    
                                    
*