Textures/garden3.bmp
13 3
13 11
1
                  
 3000700070007002 
 1   1   1   1  1 
 1 30:000600762 1 
 1 1 1      1 809 
 80:09F   E 475 1 
 1 1 1       1  1 
 1 1 1       8009 
 1 1 1  D    1  1 
 80:09      362 1 
 1 1 1G   H 1 809 
 1 40:000700675 1 
 1   1   1   1  1 
 4000600060006005 
                  
*
                                    
                                    
  2 1111111 1111111 1111111 11112   
                                    
  1       1       1       1     1   
  1       1       1             1   
  1   1 111 1111111 1111        1   
  1                             1   
  1   1   1                   111   
  1   1   1                         
  1 114 111                     1   
                                1   
  1   1   1               1     1   
  1   1   1               1     1   
  1   1   1               1 11111   
  1   1   1                         
  1   1   1               1     1   
  1   1   1               1     1   
  1 11> 111                     1   
                                1   
  1   1   1                   111   
  1   1   1                         
  1   1 111 1111111 1111        1   
  1                             1   
  1       1       1       1     1   
  1       1       1       1     1   
  2 1111111 1111111 1111111 11112   
                                    
                                    
                                    
*