Textures/garden1.bmp
6 5
10 5
0
3002         3002 
1  1  30002  1  1 
1\ 1B 1   1B 1\ 1 
800:00:000:00:009 
1  1  1   1  1  1 
1E 1D 1   1D 1F 1 
1  1  1   1  1  1 
800:00:000:00:009 
1  1  1   1  1  1 
1\ 1C 40005C 1\ 1 
4005         4005 
*
1 11112                   2 11111   
                                    
1     1     1 11=1111     1     1   
1     1                   1     1   
1     1     1       1     1     1   
1     1     1       1     1     1   
1 11111 11111 1111111 11111 11111   
                                    
1     1     1       1     1     1   
1     1     1       1     1     1   
1     1     1       1     1     1   
1     1     1       1     1     1   
1     1     1       1     1     1   
1     1     1       1     1     1   
1 11111 11111 1111111 11111 11111   
                                    
1     1     1       1     1     1   
1     1     1       1     1     1   
1     1     1 1131111     1     1   
1     1                   1     1   
1 11112                   2 11111   
                                    
*