Textures/desert1.bmp
10 7
7 7
1
300007070070700002
1    1 1  1 1    1
1    1 1  1 1    1
1    809C 809    1
1D   1 1  1 1D   1
80070609  80607009
1  1   1  1   1  1
47067009  80076075
 1  1  1B 1  1  1 
 1B 1  1  1  1  1 
 400:00:00:00:005 
    1  1  1  1    
    1A 1  1B 1    
    4006006005    
                  
                  
                  
*
2 111111111 111 11111 111 111111112 
                                    
1         1   1     1   1         1 
1         1   1     1   1         1 
1         1   1     1   1         1 
1         1   1     1   1         1 
1         1 111     1 111         1 
1                                 1 
1         1   1     1   1         1 
1         1   1     1   1         1 
1 11111 111 11:     : 111 111 11111 
                                    
1     1       1     1       1     1 
1     1       1     1       1     1 
1 1 111 1 11111     1 11111 1 111 1 
                                    
  1     1     1     1     1     1   
  1     1     1     1     1     1   
  1     1     1     1     1     1   
  1     1     1     1     1     1   
  1 11112 11111 11>11 1111= 11111   
                                    
        1     1     1     1         
        1     1     1     1         
        1     1     1     1         
        1     1     1     1         
        3 11111 11111 11113         
                                    
                                    
                                    
                                    
                                    
                                    
                                    
*