Textures/town2.bmp
9 7
9 21
0
300070000700070002
1   1    1   1   1
1   1    1 G 1   1
1C  1    1   1D  1
80005    1   40009
1    A   1 E     1
1 F      1     F 1
800000700:00700009
1     1  1  1    1
1 E   1  1  1 E  1
8000005  1  400009
1        1       1
80002H   1 H 30009
1   1    1   1   1
1   80000:0009   1
1C  1    1   1B  1
80005 F  1F  40009
1        1       1
8000002  1  300009
1     1  1  1    1
1H  G 1  1  1 G  1
800000600:00600009
1        1       1
1E       1     E 1
80002    1D  30009
1   1A   1   1   1
1   1    1   1   1
1B  1    1   1C  1
400060000600060005
                  
*
3 1111111 111111111 1111111 1111113 
                                    
1       1         1       1       1 
1       1         1       1       1 
1       1         1       1       1 
1       1         1       1       1 
1       1         1       1       1 
1       1         1       1       1 
1 1111112         1       2 1111111 
                  1                 
1                 1               1 
1                 1               1 
1                 1               1 
1                 1               1 
1 11111111111 11111 11111 111111111 
                                    
1           1     1     1         1 
1           1     1     1         1 
1           1     1     1         1 
1           1     1     1         1 
1 11111111114     1     5 111111111 
                  1                 
1                 1               1 
1                 1               1 
1 1111111         1       1 1111111 
                  1                 
1       1         1       1       1 
1       1         1       1       1 
1       1 11111111; 1111111       1 
1                                 1 
1       1         1       1       1 
1       1         1       1       1 
1 1111111         1       1 1111111 
                  1                 
1                 1               1 
1                 1               1 
1 11111111115     1     4 111111111 
                  1                 
1           1     1     1         1 
1           1     1     1         1 
1           1     1     1         1 
1           1     1     1         1 
1 11111111111 11111 11111 111111111 
                                    
1                 1               1 
1                 1               1 
1                 1               1 
1                 1               1 
1 1111112         1       2 1111111 
                  1                 
1       1         1       1       1 
1       1         1       1       1 
1       1         1       1       1 
1       1         1       1       1 
1       1         1       1       1 
1       1         1       1       1 
3 1111111 111111111 1111111 1111113 
                                    
                                    
                                    
*