Textures/town3.bmp
15 12
2 12
0
300070700007070002
1   1 1    1 1   1
1   1 1    1 1   1
1K  1 1 L  1 1B  1
8070:06000060:0709
1 1 1        1 1 1
1 1 1        1 1 1
805 1 J   I  1 409
1   1        1   1
1 309        802 1
1 1 1        1 1 1
1 1 1H  D  F 1 1 1
80609        80609
1   1        1   1
1E  1        1 E 1
1   1 B   C  1   1
8000:00700700:0009
1   1  1  1  1   1
1   1F 1G 1F 1 H 1
1K  1  1  1  1   1
400060060060060005
*
4 1111111 111 111>11111 111 1111113 
                                    
1       1   1         1   1       1 
1       1   1         1   1       1 
1       1   1         1   1       1 
1       1   1         1   1       1 
1       1   1         1   1       1 
1       1   1         1   1       1 
1 111 112 111 111111111 112 111 111 
                                    
1   1   1                 1   1   1 
1   1   1                 1   1   1 
1   1   1                 1   1   1 
1   1   1                 1   1   1 
1 111   1                 1   1 111 
        1                 1         
1       1                 1       1 
1       1                 1       1 
1   1 111                 1 111   1 
1                                 1 
1   1   1                 1   1   1 
1   1   1                 1   1   1 
1   1   1                 1   1   1 
1   1   1                 1   1   1 
1 111 111                 1 111 111 
                                    
1       1                 1       1 
1       1                 1       1 
1       1                 1       1 
1       1                 1       1 
1       1                 1       1 
1       1                 1       1 
1 1111112 11111 11111 11112 1111111 
                                    
1       1     1     1     1       1 
1       1     1     1     1       1 
1       1     1     1     1       1 
1       1     1     1     1       1 
1       1     1     1     1       1 
1       1     1     1     1       1 
3 1111111 11111 11111 11111 1111114 
                                    
*