Textures/desert2.bmp
8 14
8 8
1
                 
                 
                 
30000000700000002
1       1       1
1 300000:000002 1
1 1     1     1 1
1 1  B  1 C   1 1
80:00700600700:09
1 1  1     1  1 1
1 1  1     1  1 1
1 8009     8009 1
1 1  1 D   1  1 1
1 1  1     1  1 1
80:00600700600:09
1 1     1     1 1
1 1 B   1   A 1 1
1 400000:000005 1
1       1       1
40000000600000005
*
                                  
                                  
                                  
                                  
                                  
                                  
2 111111111111111 111111111111112 
                                  
1               1               1 
1               1               1 
1   1 1111111111> 11111111111   1 
1                               1 
1   1           1           1   1 
1   1           1           1   1 
1   1           1           1   1 
1   1           1           1   1 
1 111 1111              11111 111 
                                  
1   1                       1   1 
1   1                       1   1 
1   1                       1   1 
1   1                       1   1 
1   3 1111              11114   1 
1                               1 
1   1                       1   1 
1   1                       1   1 
1   1                       1   1 
1   1                       1   1 
1 111 1111              11111 111 
                                  
1   1           1           1   1 
1   1           1           1   1 
1   1           1           1   1 
1   1           1           1   1 
1   1 1111111111: 11111111111   1 
1                               1 
1               1               1 
1               1               1 
2 111111111111111 111111111111112 
                                  
*