Textures/desert1.bmp
10 7
7 7
1
300007070070700002
1    1 1  1 1    1
1    1 1  1 1    1
1    1 1C 1 1    1
1D   1 1  1 1D   1
80070609  80607009
1  1   1  1   1  1
80067009  80076009
1   1  1B 1  1   1
1B  1  1  1  1   1
4070600:00:0060705
  1    1  1    1  
  1A   1  1 B  1  
  800009  800009  
  1    1  1    1  
  1 C  1  1    1  
  40000600600005  
*
2 111111111 111 11111 111 111111112 
                                    
1         1   1     1   1         1 
1         1   1     1   1         1 
1         1   1     1   1         1 
1         1   1     1   1         1 
1         1   1     1   1         1 
1         1   1     1   1         1 
1         1   1     1   1         1 
1         1   1     1   1         1 
1 11111 111 11:     : 111 111 11111 
                                    
1     1       1     1       1     1 
1     1       1     1       1     1 
1 11111 1 11111     1 11111 1 11111 
                                    
1       1     1     1     1       1 
1       1     1     1     1       1 
1       1     1     1     1       1 
1       1     1     1     1       1 
1 112 111 11111 11>11 11111 112 111 
                                    
    1         1     1         1     
    1         1     1         1     
    1         1     1         1     
    1         1     1         1     
    1 111111111     1 111111111     
                                    
    1         1     1         1     
    1         1     1         1     
    1         1     1         1     
    1         1     1         1     
    3 111111111 11111 111111113     
                                    
*