Textures/classic8.bmp
10 13
7 13
1
                  
                  
                  
300002      300002
1    1      1    1
1    1      1    1
40000:070070:00005
     1 1  1 1     
     1 8009 1     
3002 1 1  1 1 3002
1  1 805  409 1  1
1  1 1      1 1  1
1  1 1 3002 1 1  1
800:0:09  80:0:009
1  1 1 4005 1 1  1
1  1 1      1 1  1
1  1 802  309 1  1
4005 1 1  1 1 4005
     1 8009 1     
     1 1  1 1     
300009 1  1 800002
1    1 8009 1    1
1    1 1  1 1    1
40000605  40600005
                  
                  
                  
                  
*
                                    
                                    
                                    
                                    
                                    
                                    
2 111111111             1 111111112 
                                    
1         1             1         1 
1         1             1         1 
1         1             1         1 
1         1             1         1 
3 11111111B 111 11111 114 111111113 
                                    
          1   1     1   1           
          1   1     1   1           
          1   1 11111   1           
          1             1           
1 11111   1   1     1   1   1 11111 
          1   1     1   1           
1     1   1 111     1 111   1     1 
1     1                     1     1 
1     1   1             1   1     1 
1     1   1             1   1     1 
1     1   1             1   1     1 
1     1   1             1   1     1 
: 1111= 111 11        111 11= 1111: 
                                    
1     1   1             1   1     1 
1     1   1             1   1     1 
1     1   1             1   1     1 
1     1   1             1   1     1 
1     1   1 111     1 111   1     1 
1     1                     1     1 
1 11111   1   1     1   1   1 11111 
          1   1     1   1           
          1   1 11111   1           
          1             1           
          1   1     1   1           
          1   1     1   1           
3 111111111   1     1   1 111111113 
              1     1               
1         1   1 11111   1         1 
1         1             1         1 
1         1   1     1   1         1 
1         1   1     1   1         1 
2 111111111 116     6 111 111111112 
                                    
                                    
                                    
                                    
                                    
                                    
                                    
                                    
                                    
*