Textures/garden3.bmp
8 5
8 10
1
                 
  30007000070002 
G 1   1    1   1F
  1 3067007602 1 
  1 1  1  1  809 
  809 360062 1 1 
  1 809    809 1 
  1 1 1S U 1 1 1 
B 1 1 1    1 1 1B
  1 809M O 809 1 
  809 470075 809 
  1 1  1  1  1 1 
  1 4076006705 1 
  1   1    1   1 
H 40006000060005E
                 
*
                                  
                                  
    2 1111111 111111111 1111112   
                                  
    1       1         1       1   
    1       1         1       1   
    1   3 111 1 11111 1 11=   1   
    1                         1   
    1   1     1     1     1 111   
    1   1     1     1             
    1 111        :        1   1   
                          1   1   
    1   1 11            111   1   
    1                         1   
    1   1                 1   1   
    1   1                 1   1   
    1   1                 1   1   
    1   1                 1   1   
    1   1 11            111   1   
    1                         1   
    1 111       :         1 111   
                                  
    1   1     1     1     1   1   
    1   1     1     1     1   1   
    1   > 111 1 11111 1 113   1   
    1                         1   
    1       1         1       1   
    1       1         1       1   
    2 1111111 111111111 1111112   
                                  
                                  
                                  
*