Textures/classic5.bmp
13 5
2 5
1
 30700700700702 
 1 1  1  1  1 1 
 80600:00:00609 
 1    1  1    1 
362   1  1   362
1 8000:00:0009 1
475   1  1   475
 1    1  1    1 
 80700:00:00709 
 1 1  1  1  1 1 
 40600600600605 
*
  2 111 11111 1>111 11111 112   
                                
  1   1     1     1     1   1   
  1   1     1     1     1   1   
  1 116 11111 11111 11116 111   
                                
  1         1     1         1   
  1         1     1         1   
            1     1             
            1     1             
      1111111 11111 111111      
                                
            1     1             
            1     1             
  1         1     1         1   
  1         1     1         1   
  1 116 11111 11111 11116 111   
                                
  1   1     1     1     1   1   
  1   1     1     1     1   1   
  2 111 11111 1:111 11111 112   
                                
*
