Textures/grave1.bmp
11 7
6 7
1
 3070700000070702 
 1 1 1      1 1 1 
 80609I L I 80609 
 1   1      1   1 
 1 3062    3602 1 
 1 1  1    1  1 1 
 809  1 K  1  809 
 1 800:0000:009 1 
 1 1  1    1  1 1 
 1 1  1 H  1  1 1 
 406709    807605 
    1 1    1 1    
    8067007609    
    1  1  1  1    
    4006006005    
                  
                  
                  
                  
*
  2 111 111 1111111111111 111 112   
                                    
  1   1   1             1   1   1   
  1   1   1             1   1   1   
  1 111 115             > 111 111   
                                    
  1       1             1       1   
  1       1             1       1   
  1   1 111           1 1 111   1   
  1                             1   
  1   1               1     1   1   
  1   1               1     1   1   
  1 111               1     1 111   
                      1             
  1   1                 11111   1   
  1                             1   
  1   1               1     1   1   
  1   1               1     1   1   
  1   1               1     1   1   
  1   1               1     1   1   
  2 111               1 111 1 112   
                                    
        1   1         1   1         
        1   1         1   1         
        1 111 4 11114 1 111         
                                    
        1     1     1     1         
        1     1     1     1         
        1 11111 11111 11111         
                                    
                                    
                                    
                                    
                                    
                                    
                                    
                                    
                                    
*