Textures/town2.bmp
10 12
7 7
0
    3007007002    
    1  1  1  1    
    1F 1  1F 1    
 C  1  1  1  1 L  
30005  1  1  40002
1      1  1      1
1G   E 1  1E   G 1
80000705  40700009
1    1      1    1
1    1      1    1
1 B  1      1 K  1
1    1 A    1    1
80000602  30600009
1      1  1      1
1H   G 1  1G   H 1
40007009  80070005
    1  1  1  1    
    1F 1  1F 1    
    1  1  1  1    
 I  4006006005 J  
*
        1 11111 11=11 11111         
                                    
        1     1     1     1         
        1     1     1     1         
        1     1     1     1         
        1     1     1     1         
        1     1     1     1         
        1     1     1     1         
6 1111112     1     1     2 1111113 
              1     1               
1             1     1             1 
1             1     1             1 
1             1     1             1 
1             1     1             1 
1 111111111 111     1 111 111111111 
                                    
1         1             1         1 
1         1             1         1 
1         1             1         1 
1         1             1         1 
1         1             1         1 
1         1             1         1 
1         1             1         1 
1         1             1         1 
1 111111111 111     1 111 111111111 
                                    
1             1     1             1 
1             1     1             1 
1             1     1             1 
1             1     1             1 
3 1111112 11111     1 11112 1111116 
                                    
        1     1     1     1         
        1     1     1     1         
        1     1     1     1         
        1     1     1     1         
        1     1     1     1         
        1     1     1     1         
        1 11111 11;11 11111         
                                    
*