Textures/classic6.bmp
5 12
12 12
1
     30000002     
     1      1     
     1 3002 1     
     1 1  1 1     
     809  809     
     1 1  1 1     
     1 1  1 1     
     1 1  1 1     
300709 1  1 807002
1  1 1 1  1 1 1  1
1  1 809  809 1  1
8005 1 1  1 1 4009
1    80677609    1
802  1  11  1  309
1 1  1  11  1  1 1
406009  11  800605
     1  11  1     
     80054009     
     1      1     
     80023009     
     1  11  1     
     1  11  1     
     1  11  1     
     1  11  1     
     40066005     
*
          3 1111111111113           
                                    
          1             1           
          1             1           
          1   > 1111<   1           
          1             1           
          1   1     1   1           
          1   1     1   1           
          1 111     1 111           
                                    
          1   1     1   1           
          1   1     1   1           
          1   1     1   1           
          1   1     1   1           
          1   1     1   1           
          1   1     1   1           
2 11111 111   1     1   1 111 11112 
              1     1               
1     1   1   1     1   1   1     1 
1     1   1   1     1   1   1     1 
1     1   1 111             1     1 
1     1                     1     1 
1 11111   1   1             1 11111 
          1   1                     
1         1 111 1 1               1 
1                                 1 
1 111     1     1 1     1     1 111 
          1     1 1     1           
1   1     1     1 1     1     1   1 
1   1     1     1 1     1     1   1 
2 111 11111     1 1     1 11111 112 
                1 1                 
          1     1 1     1           
          1     1 1     1           
          1 11114 5 11111           
                                    
          1             1           
          1             1           
          1 1111: 1 11111           
                                    
          1     1 1     1           
          1     1 1     1           
          1     1 1     1           
          1     1 1     1           
          1     1 1     1           
          1     1 1     1           
          1     1 1     1           
          1     1 1     1           
          3 11111 1 11113           
                                    
*