Textures/grave2.bmp
5 6
12 6
1
30002  3002  30002
1   1A 1  1A 1   1
1   800:00:009   1
1 E 1  1  1  1E  1
40705  1C 1  40705
  1  309  802  1  
  8009 8009 8009  
  1  409  805  1  
30602  1B 1  30602
1   1  1  1  1   1
1 E 800:00:009E  1
1   1  1  1  1   1
40005A 4005A 40005
*
2 1111111     4 1111>     1 1111112 
                                    
1       1     1     1     1       1 
1       1     1     1     1       1 
1       1 11111 11111 11111       1 
1                                 1 
1       1     1     1     1       1 
1       1     1     1     1       1 
1 111 115     1     1     5 111 111 
              1     1               
    1     1 111     1 111     1     
    1                         1     
    1 11111   1 11111   1 11111     
                                    
    1     1 111     1 111     1     
    1                         1     
1 111 115     1     1     5 111 111 
              1     1               
1       1     1     1     1       1 
1       1     1     1     1       1 
1       1 11111 11111 11111       1 
1                                 1 
1       1     1     1     1       1 
1       1     1     1     1       1 
2 1111111     : 11114     1 1111112 
                                    
*