Textures/desert1.bmp
9 7
9 9
1
                  
     307000702    
     1 1   1 1    
     1 1   1 1    
   3060:000:0602  
   1   1   1   1  
   1   1 A 1 C 1  
 30:000:000:000:02
 1 1   1   1   1 1
 40:07060706070:05
   1 1   1   1 1  
   1 1 B 1   1 1  
   40:0706070:05  
     1 1   1 1    
     1 1   1 1    
     406000605    
                  
*
                                    
                                    
          4 111 1111111 113         
                                    
          1   1       1   1         
          1   1       1   1         
          1   1       1   1         
          1   1       1   1         
      1 112 111 1111111 112 111     
                                    
      1       1       1       1     
      1       1       1       1     
      1       1       1       1     
      1       1       1       1     
  1 111 1111111 1111111 1111111 111 
                                    
  1   1       1       1       1   1 
  1   1       1       1       1   1 
  1 111 111               1 111 111 
                                    
      1   1               1   1     
      1   1               1   1     
      1   1               1   1     
      1   1               1   1     
      1 112 111 11> 111 112 111     
                                    
          1   1       1   1         
          1   1       1   1         
          1   1       1   1         
          1   1       1   1         
          3 111 1111111 114         
                                    
                                    
                                    
*