Textures/classic.bmp
9 3
9 6
1
 30707000700070702
 1 1 1   1   1 1 1
 1 409   1   805 1
 1   1 30602 1   1
 8070:09   80602 1
 1 1 1 1   1   809
 809 1 40705 309 1
 1 1 1   1   1 1 1
 1 40:000:0009 1 1
 1   1   1   1 1 1
 40006000600060605
*
  2 111 111 111111> 1111111 111 112 
                                    
  1   1   1       1       1   1   1 
  1   1   1       1       1   1   1 
  1   1 111       1       1 111   1 
  1               1               1 
  1       1               1       1 
  1       1               1       1 
  1 111 111 11          111 111   1 
                                  1 
  1   1   1                   1 111 
  1   1   1                         
  1 111   1               1 111   1 
          1                       1 
  1   1   1       1       1   1   1 
  1   1   1       1       1   1   1 
  1   1 111 1111111 1111111   1   1 
  1                           1   1 
  1       1       1       1   1   1 
  1       1       1       1   1   1 
  2 1111111 1111113 1111111 111 112 
                                    
*