Textures/classic6.bmp
5 10
11 8
1
     3007002      
     1  1  1      
     1 362 1      
     1 1 1 1      
     809 809      
     1 1 1 1      
 30709 1 1 80702  
 1 1 1 1 1 1 1 1  
 805 809 809 409  
 1   1 1 1 1   1  
 802 80:0:09 309  
 1 1 1 1 1 1 1 1  
 40609 1 1 80605  
     1 1 1 1      
     805 409      
     1     1      
     802 309      
     1 1 1 1      
     4060605      
                  
                  
                  
*
          3 11111 11113             
                                    
          1     1     1             
          1     1     1             
          1   > 1 =   1             
          1           1             
          1   1   1   1             
          1   1   1   1             
          1 111   1 111             
                                    
          1   1   1   1             
          1   1   1   1             
  2 111 111   1   1   1 111 112     
              1   1                 
  1   1   1   1   1   1   1   1     
  1   1   1   1   1   1   1   1     
  1 111   1 111           1 111     
                                    
  1       1   1               1     
  1       1   1               1     
  1 111   1 111 11        1 111     
                                    
  1   1   1   1   1   1   1   1     
  1   1   1   1   1   1   1   1     
  2 111 111   1   1   1 111 112     
              1   1                 
          1   1   1   1             
          1   1   1   1             
          1 114   5 111             
                                    
          1           1             
          1           1             
          1 11:   1 111             
                                    
          1   1   1   1             
          1   1   1   1             
          3 111 111 113             
                                    
                                    
                                    
                                    
                                    
                                    
                                    
*