Textures/grave1.bmp
11 7
6 7
0
300007000000700002
1    1      1    1
800009I L I 800009
1    1      1    1
1  3062    3602  1
1  1  1    1  1  1
1  1  1 K  1  1  1
800:00:0000:00:009
1  1  1    1  1  1
1  1  1 H  1  1  1
1G 4705    4075G 1
1   1        1   1
1   8000000009   1
1   1        1   1
400060000000060005
                  
                  
                  
                  
*
2 111111111 1111111111111 111111112 
                                    
1         1             1         1 
1         1             1         1 
1 111111115             9 111111111 
                                    
1         1             1         1 
1         1             1         1 
1     1 111 1         1 1 111     1 
1                                 1 
1     1     1         1     1     1 
1     1     1         1     1     1 
1     1     1         1     1     1 
1     1     1         1     1     1 
1 11111 11111 111111111 11111 11111 
                                    
1     1     1         1     1     1 
1     1     1         1     1     1 
1     1     1         1     1     1 
1     1     1         1     1     1 
1     1 1 111         1 111 1     1 
1                                 1 
1       1                 1       1 
1       1                 1       1 
1       1 11114111111411111       1 
1                                 1 
1       1                 1       1 
1       1                 1       1 
2 1111111 11111111111111111 1111112 
                                    
                                    
                                    
                                    
                                    
                                    
                                    
                                    
                                    
*