Textures/classic10.bmp
2 8
15 5
1
307007070070700702
1 1  1 1  1 1  1 1
40:00:09  80:00:05
  1  1 1  1 1  1  
  1 3606006062 1  
  809        809  
  1 1        1 1  
  1 1        1 1  
  809        809  
  1 4707007075 1  
  1  1 1  1 1  1  
30:00:09  80:00:02
1 1  1 1  1 1  1 1
406006060060600605
*
3 111 11111 111 11111 111 11111 113 
                                    
1   1     1   1     1   1     1   1 
1   1     1   1     1   1     1   1 
1 11= 11111 111     1 111 1111= 111 
                                    
    1     1   1     1   1     1     
    1     1   1     1   1     1     
    1   2 1 111 11111 111 2   1     
    1                         1     
    1 111                 1 111     
                                    
    1   1                 1         
    1   1                 1         
    1   1                 1         
    1   1                 1         
    1 111                 1 111     
                                    
    1   2 1 111 11111 111 2   1     
    1                         1     
    1     1   1     1   1     1     
    1     1   1     1   1     1     
1 11: 11111 111     1 111 1111> 111 
                                    
1   1     1   1     1   1     1   1 
1   1     1   1     1   1     1   1 
3 111 11111 111 11111 111 11111 113 
                                    
*