Textures/desert1.bmp
9 16
9 20
0
   3000000000002  
   1           1  
   1   30002   1  
   1D  1   1D  1  
 30:000:000:000:02
 1 1   1   1   1 1
 1 1 A 1   1   1 1
 1 1   1   1C  1 1
 80:0005   4000:09
 1 1           1 1
 1 1           1 1
 1 1    D      1 1
 80:0002   3000:09
 1 1   1   1   1 1
 1 1   1   1   1 1
 1 1B  1   1A  1 1
 80:070:000:070:09
 1 1 1 1   1 1 1 1
 1 1 1 40705 1 1 1
 1 1 1   1   1 1 1
 1 1 4000:0005 1 1
 1 1     1     1 1
 1 400000:000005 1
 1       1       1
 40000000600000005
*
      6 1111111111:111111111113     
                                    
      1                       1     
      1                       1     
      1       1 1111111       1     
      1                       1     
      1       1       1       1     
      1       1       1       1     
  1 111 1111111 111;111 1111111 111 
                                    
  1   1       1       1       1   1 
  1   1       1       1       1   1 
  1   1       1       1       1   1 
  1   1       1       1       1   1 
  1   1       1       1       1   1 
  1   1       1       1       1   1 
  1 111 1111116       5 1111111 111 
                                    
  1   1                       1   1 
  1   1                       1   1 
  1   1                       1   1 
  1   1                       1   1 
  1   1                       1   1 
  1   1                       1   1 
  1 111 1111115       6 1111111 111 
                                    
  1   1       1       1       1   1 
  1   1       1       1       1   1 
  1   1       1       1       1   1 
  1   1       1       1       1   1 
  1   1       1       1       1   1 
  1   1       1       1       1   1 
  1 111 111 111 1111111 111 111 111 
                                    
  1   1   1   1       1   1   1   1 
  1   1   1   1       1   1   1   1 
  1   1   1   1 111 111   1   1   1 
  1   1   1               1   1   1 
  1   1   1       1       1   1   1 
  1   1   1       1       1   1   1 
  1   1   1 1111111 1111111   1   1 
  1   1                       1   1 
  1   1           1           1   1 
  1   1           1           1   1 
  1   2 11111111111 11111111112   1 
  1                               1 
  1               1               1 
  1               1               1 
  2 111111111111111 111111111111112 
                                    
*