Textures/garden2.bmp
8 2
8 13
1
30000000700000002
1       1       1
802    362    309
1 400009 800005 1
1      475      1
1  B    1 D  B  1
80000000:00000009
1       1       1
1C  3000:0002 C 1
1   1   1   1   1
1   1G 362E 1   1
1 306009 800602 1
805    475    409
1       1       1
40000000600000005
*
2 111111111111119 111111111111112 
                                  
1               1               1 
1               1               1 
1 111         1 1 1         1 111 
                                  
1   1 111511111   1 111115111   1 
1                               1 
1             1 1 1             1 
1                               1 
1               1               1 
1               1               1 
1 111111111111111 111111111111111 
                                  
1               1               1 
1               1               1 
1       6 1111111 1111116       1 
1                               1 
1       1       1       1       1 
1       1       1       1       1 
1       1     1 1 1     1       1 
1       1               1       1 
1   1 111 11111   1 11111 111   1 
1                               1 
1 111         1 1 1         1 111 
                                  
1               1               1 
1               1               1 
2 11111111111111< 111111111111112 
                                  
*