Textures/town1.bmp
10 6
6 10
1
 300700070007002  
 1  1   1   1  1  
 8076000:0006709  
 1 1    1    1 1  
 805    1    409  
 1   C  1B     1  
 800007060700009  
 1    1   1    1  
 1    1   1    1  
 1 I  1B  1 L  1  
 800006070600009  
 1      1      1  
 802    1    309  
 1 1 J  1 K  1 1  
 8067000:0007609  
 1  1   1   1  1  
 400600060006005  
*
  5 11111 111111= 1111111 11116     
                                    
  1     1       1       1     1     
  1     1       1       1     1     
  1 111 1 1111111 1111111 1 111     
                                    
  1   1         1         1   1     
  1   1         1         1   1     
  1 112         1         2 111     
                1                   
  1             1             1     
  1             1             1     
  1 11111111          111111111     
                                    
  1                           1     
  1                           1     
  1                           1     
  1                           1     
  1                           1     
  1                           1     
  1 11111111          111111111     
                                    
  1             1             1     
  1             1             1     
  1 112         1         2 111     
                1                   
  1   1         1         1   1     
  1   1         1         1   1     
  1 111 1 1111111 1111111 1 111     
                                    
  1     1       1       1     1     
  1     1       1       1     1     
  6 11111 111111> 1111111 11115     
                                    
*