Textures/desert1.bmp
9 7
9 9
0
    30070007002   
    1  1   8  1   
    1  1   1  1   
    1  1D  1  1   
 30060760006706002
 1    1     1    1
 1    1 A   1 C  1
 80000600000600009
 1               1
 80070000700007009
 1  1    1    1  1
 1  1 B  1    1  1
 400:007060700:005
    1  1   1  1   
    1  1   1  1   
    1  1D  1  1   
    40060006005   
*
        4 11111 1111111 11113       
                                    
        1     1       1     1       
        1     1             1       
        1     1       1     1       
        1     1       1     1       
        1     1       1     1       
        1     1       1     1       
  1 11112 111 1 1111111 2 111 11111 
                                    
  1         1           1         1 
  1         1           1         1 
  1         1           1         1 
  1         1           1         1 
  1 111111111 11111111111 111111111 
                                    
  1                               1 
  1                               1 
  1 11111 11111111= 111111111 11111 
                                    
  1     1         1         1     1 
  1     1         1         1     1 
  1     1         1         1     1 
  1     1         1         1     1 
  1 11112 11111 111 111 11111 11111 
                                    
        1     1       1     1       
        1     1       1     1       
        1     1       1     1       
        1     1       1     1       
        1     1       1     1       
        1     1       1     1       
        3 11111 1111111 11114       
                                    
*