Textures/classic7.bmp
10 10
6 10
1
                  
3007002   3007002 
1  1  1   1  1  1 
1 360062 360062 1 
1 1    809    1 1 
409 3009 8002 805 
  1 1  1 1  1 1   
  1 1 36062 1 1   
  1 1 1   1 1 1   
  80:09   80:09   
  1 1 1   1 1 1   
  1 1 47075 1 1   
  1 1  1 1  1 1   
309 4009 8005 802 
1 1    809    1 1 
1 470075 470075 1 
1  1  1   1  1  1 
4006005   4006005 
                  
                  
*
                                    
                                    
2 11111 11111       1 11111 11112   
                                    
1     1     1       1     1     1   
1     1     1       1     1     1   
1   6 1 11111 1   1 1 11111 4   1   
1                               1   
1   1         1 111         1   1   
1   1                       1   1   
1 111   1 11111   1 11111   1 111   
                                    
    1   1     1   1     1   1       
    1   1     1   1     1   1       
    1   1               1   1       
    1   1               1   1       
    1   1               1   1       
    1   1               1   1       
    > 111               1 11=       
                                    
    1   1               1   1       
    1   1               1   1       
    1   1               1   1       
    1   1               1   1       
    1   1     1   1     1   1       
    1   1     1   1     1   1       
1 111   1 11111   1 11111   1 111   
                                    
1   1         1 111         1   1   
1   1                       1   1   
1   3 1 11111 1   1 1 11111 5   1   
1                               1   
1     1     1       1     1     1   
1     1     1       1     1     1   
2 11111 11111       1 11111 11112   
                                    
                                    
                                    
                                    
                                    
*