Textures/grave1.bmp
6 8
12 8
1
        302       
  3000009 8000002 
  1     475     1 
  1J     1    K 1 
  80002  1  30009 
  1   1  1  1   1 
  1   1  1  1   1 
 362  1  1  1  362
 1 800:00:00:009 1
 475  1  1  1  475
  1 G 1  1  1G  1 
  1   1  1  1   1 
  80005  1  40009 
  1      1      1 
  1H    362   I 1 
  4000009 8000005 
        405       
*
                1 111               
                                    
    2 11111111111   1 11111111112   
                                    
    1           1 6 1           1   
    1                           1   
    1             1             1   
    1             1             1   
    1 1111114     1     4 1111111   
                  1                 
    1       1     1     1       1   
    1       1     1     1       1   
    1       1     1     1       1   
    1       1     1     1       1   
  1 1 1     1     1     1     1 1 1 
            1     1     1           
  1   5 11111 1111= 11111 11115   1 
  1                               1 
  1 1 1     1     1     1     1 1 1 
            1     1     1           
    1       1     1     1       1   
    1       1     1     1       1   
    1       1     1     1       1   
    1       1     1     1       1   
    1 1111114     1     4 1111111   
                  1                 
    1             1             1   
    1             1             1   
    1           1 6 1           1   
    1                           1   
    2 11111111111   1 11111111112   
                                    
                1 111               
                                    
*