Textures/desert1.bmp
9 7
9 9
1
    30700000702   
    1 1     1 1   
    1 1     1 1   
    1 1 D   1 1   
 30060:00000:06002
 1    1     1    1
 1    1 A   1 C  1
 80000600000600009
 1               1
 80070000700007009
 1  1    1    1  1
 1  1 B  1    1  1
 400:070060070:005
    1 1     1 1   
    1 1     1 1   
    1 1 D   1 1   
    40600000605   
*
        4 111 11111111111 113       
                                    
        1   1           1   1       
        1   1           1   1       
        1   1           1   1       
        1   1           1   1       
        1   1           1   1       
        1   1           1   1       
  1 11112 111 11111111112 111 11111 
                                    
  1         1           1         1 
  1         1           1         1 
  1         1           1         1 
  1         1           1         1 
  1 111111111 11111111111 111111111 
                                    
  1                               1 
  1                               1 
  1 11111                   1 11111 
                                    
  1     1                   1     1 
  1     1                   1     1 
  1     1                   1     1 
  1     1                   1     1 
  1 11112 111 1111> 11112 111 11111 
                                    
        1   1           1   1       
        1   1           1   1       
        1   1           1   1       
        1   1           1   1       
        1   1           1   1       
        1   1           1   1       
        3 111 11111111111 114       
                                    
*