Textures/classic.bmp
9 3
9 6
1
307007000700007002
1 1  1   1    1  1
1 4009   1    1  1
1    1 30602  1  1
80000:09   80062 1
1    1 1   1   809
802  1 40705 309 1
1 1  1   1   1 1 1
1 400:000:0005 1 1
1    1   1     1 1
400006000600000605
*
2 111 11111 1111111 111111111 11112 
                                    
1   1     1       1         1     1 
1   1     1       1         1     1 
1   1 11111       1         1     1 
1                 1         1     1 
1         1                 1     1 
1         1                 1     1 
1 111111111 11          11111 1   1 
                                  1 
1         1                   1 111 
1         1                         
1 111     1               1 111   1 
          1                       1 
1   1     1       1       1   1   1 
1   1     1       1       1   1   1 
1   1 11111 1111111 1111111   1   1 
1                             1   1 
1         1       1           1   1 
1         1       1           1   1 
2 111111111 1111111 11111111111 112 
                                      
*