Textures/classic5.bmp
15 5
2 5
1
 3007000000007002 
 1  1        1  1 
 8006007007006009 
 1     1  1     1 
362    1  1    362
1 80000:00:00009 1
475    1  1    475
 1     1  1     1 
 8007006006007009 
 1  1        1  1 
 4006000000006005 
*
  2 11111 1111111>111111111 11112   
                                    
  1     1                 1     1   
  1     1                 1     1   
  1 11116 11111 11111 11116 11111   
                                    
  1           1     1           1   
  1           1     1           1   
              1     1               
              1     1               
      111111111 11111 11111111      
                                    
              1     1               
              1     1               
  1           1     1           1   
  1           1     1           1   
  1 11116 11111 11111 11116 11111   
                                    
  1     1                 1     1   
  1     1                 1     1   
  2 11111 1111111:111111111 11112   
                                    
*