Textures/garden1.bmp
6 6
9 9
1
   3007007002     
   1  1  1  1     
   1\ 1D 1\ 1     
   400:00:005     
      1  1        
 C  B 1G 1B  C    
3007005  4007002  
1  1        1  1  
1\ 1E  \  F 1\ 1  
800:002  300:009  
1  1  1  1  1  1  
4009  1H 1  8005  
   400:00:005     
 B    1  1   C    
      4005        
*
      1 11114 11113 11111           
                                    
      1     1     1     1           
      1     1     1     1           
      1     1     1     1           
      1     1     1     1           
      1 11111 11111 11111           
                                    
            1     1                 
            1     1                 
            1     1                 
            1     1                 
6 11111 11111     = 11111 11116     
                                    
1     1                 1     1     
1     1                 1     1     
1     1                 1     1     
1     1                 1     1     
1 11111 1111>     1 11111 11111     
                                    
1     1     1     1     1     1     
1     1     1     1     1     1     
: 11111     1     1     1 1111:     
            1     1                 
      2 11111 11111 11112           
                                    
            1     1                 
            1     1                 
            3 11114                 
                                    
*