Textures/garden2.bmp
8 2
8 13
1
  3070007000702
  1 1   1   1 1
  809G 362H 809
  1 8009 8009 1
  1 1  475  1 1
  1 1B  1 B 1 1
  8060706070609
  1   1   1   1
  1C 3607062C 1
  8009  1  8009
  1  1 362 1  1
  1 3609 8062 1
  809  475  809
  1 1E  1 F 1 1
  4060006000605
*
    2 111 111111: 1111111 112 
                              
    1   1       1       1   1 
    1   1       1       1   1 
    1 111               1 111 
                              
    1   1 1511      15111   1 
    1                       1 
    1   1               1   1 
    1   1               1   1 
    1   1       1       1   1 
    1   1       1       1   1 
    1 111 111 11> 111 111 111 
                              
    1       1       1       1 
    1       1       1       1 
    1     6 1 111 111 6     1 
    1                       1 
    1 11111     1     1 11111 
                              
    1     1           1     1 
    1     1           1     1 
    1   1 1 11      11111   1 
    1                       1 
    1 111               1 111 
                              
    1   1       1       1   1 
    1   1       1       1   1 
    2 111 111111: 1111111 112 
                              
*