Textures/desert1.bmp
10 7
7 7
1
300000070070000002
1      1  1      1
407002 1  1 300705
  1  1 1  1 1  1  
  1  1 1C 1 1  1  
  400:09  80:005  
     1 1  1 1     
     80:00:09     
  D  1 1  1 1D    
  300:09  80:002  
  1  1 1  1 1  1  
  1  1 1  1 1  1  
306005 1B 1 400602
1      1  1      1
400000060060000005
*
2 1111111111111 11111 1111111111112 
                                    
1             1     1             1 
1             1     1             1 
1 111 11113   1     1   1 11111 111 
              1     1               
    1     1   1     1   1     1     
    1     1   1     1   1     1     
    1     1   1     1   1     1     
    1     1   1     1   1     1     
    5 11111 111     1 111 1111:     
                                    
          1   1     1   1           
          1   1     1   1           
          1 111 11111 111           
                                    
          1   1     1   1           
          1   1     1   1           
    9 11111 111     1 111 11116     
                                    
    1     1   1     1   1     1     
    1     1   1     1   1     1     
    1     1   1     1   1     1     
    1     1   1     1   1     1     
1 111 11111   1     1   3 11111 111 
              1     1               
1             1     1             1 
1             1     1             1 
2 1111111111111 11111 1111111111112 
                                    
*