Textures/classic4.bmp
6 4
6 6
1
  3000707070002 
  1   1 1 1   1 
  807060:060709 
  1 1   1   1 1 
  806000:000609 
  1     1     1 
  807000:000709 
  1 1   1   1 1 
  806070:070609 
  1   1 1 1   1 
  4000606060005 
*
    2 1111111 11: 111 1111112   
                                
    1       1   1   1       1   
    1       1   1   1       1   
    1 114 111 111 111 113 111   
                                
    1   1       1       1   1   
    1   1       1       1   1   
    1 111 1111111 1111111 111   
                                
    1                       1   
    1                       1   
    1 111               1 111   
                                
    1   1               1   1   
    1   1               1   1   
    1 113 111 111 111 114 111   
                                
    1       1   1   1       1   
    1       1   1   1       1   
    2 1111111 11> 111 1111112   
                                
*