Textures/town1.bmp
7 12
7 8
0
300070000007000002
1   1      1     1
1   1      1     1
1B  1C  D  1  C  1
8000:0007006700009
1   1   1   1    1
1   1   1   1    1
1C  1D  1B  1    1
8000600760005A   1
1      1         1
1      1 H       1
1B     80000000009
80007009         1
1   1  1E   G  E 1
1   1F 40700070009
1B  1    1   1   1
400060000600060005
                  
*
2 1111111 1111111111111 11111111112 
                                    
1       1             1           1 
1       1             1           1 
1       1             1           1 
1       1             1           1 
1       1             1           1 
1       1             1           1 
1 1111111 1111111 11114 1 111111111 
                                    
1       1       1       1         1 
1       1       1       1         1 
1       1       1       1         1 
1       1       1       1         1 
1       1       1       1         1 
1       1       1       1         1 
1 1111111 11111 1 1111111         = 
                                  1 
1             1                   1 
1             1                   1 
1             1                   1 
1             1                   1 
1             1 1111111111111111111 
1                                   
1 1111115 11111                   1 
                                  1 
1       1     1                   1 
1       1     1                   1 
1       1     1 111 1111111 1111111 
1       1                           
1       1         1       1       1 
1       1         1       1       1 
2 1111111 111111111 1111111 1111112 
                                    
                                    
                                    
*