Textures/desert2.bmp
8 14
8 8
1
                 
                 
                 
30070070007007002
1  1  1   1  1  1
1 3600607060062 1
809     1     809
1 1  B  1 C   1 1
80:00700600700:09
1 1  1     1  1 1
1 1  1     1  1 1
1 8009     8009 1
1 1  1 D   1  1 1
1 1  1     1  1 1
80:00600700600:09
1 1     1     1 1
809 B   1   A 809
1 4700706070075 1
1  1  1   1  1  1
40060060006006005
*
                                  
                                  
                                  
                                  
                                  
                                  
2 11111 11111 1111111 11111 11112 
                                  
1     1     1       1     1     1 
1     1     1       1     1     1 
1   1 1 11111 11> 111 11111 1   1 
1                               1 
1 111           1           1 111 
                1                 
1   1           1           1   1 
1   1           1           1   1 
1 111 1111              11111 111 
                                  
1   1                       1   1 
1   1                       1   1 
1   1                       1   1 
1   1                       1   1 
1   3 1111              11114   1 
1                               1 
1   1                       1   1 
1   1                       1   1 
1   1                       1   1 
1   1                       1   1 
1 111 1111              11111 111 
                                  
1   1           1           1   1 
1   1           1           1   1 
1 111           1           1 111 
                1                 
1   1 1 11111 11: 111 11111 1   1 
1                               1 
1     1     1       1     1     1 
1     1     1       1     1     1 
2 11111 11111 1111111 11111 11112 
                                  
*