Textures/grave1.bmp
6 8
12 8
1
      3007002     
    G 1  1  1G    
      1 362 1     
   300609 806002  
   1    475    1  
   8002  1  3009  
   1  1  1  1  1  
  362 1J 1K 1 362 
  1 80:00:00:09 1 
  475 1  1  1 475 
   1  1H 1I 1  1  
   8005  1  4009  
   1    362    1  
   400709 807005  
      1 475 1     
    G 1  1  1G    
      4006005     
*
            1 11111 11111           
                                    
            1     1     1           
            1     1     1           
            1   1 1 1   1           
            1           1           
      2 11111 111   1 111 11112     
                                    
      1         1 6 1         1     
      1                       1     
      1 11114     1     4 11111     
                  1                 
      1     1     1           1     
      1     1     1           1     
    1 1 1   1     1         1 1 1   
            1     1                 
    1   5 111     >         5   1   
    1                           1   
    1 1 1   1     1         1 1 1   
            1     1                 
      1     1     1           1     
      1     1     1           1     
      1 11114     1     4 11111     
                  1                 
      1         1 6 1         1     
      1                       1     
      2 11111 111   1 111 11112     
                                    
            1   1 1 1   1           
            1           1           
            1     1     1           
            1     1     1           
            1 11111 11111           
                                    
*