Textures/garden3.bmp
8 5
8 10
1
 3000000700000002
 1      1       1
 1 300076070002 1
 1 1   1  1   1 1
 1 1C  1  1 H 1 1
 1 1  360062  1 1
 1 8009    8009 1
 1 1  1S U 1  1 1
 809D 1    1B 809
 1 8009M O 8009 1
 1 1  470075  1 1
 1 1E  1  1 C 1 1
 1 1   1  1   1 1
 1 400067060005 1
 1      1       1
 4000000600000005
*
  2 1111111111111 111111111111112 
                                  
  1             1               1 
  1             1               1 
  1   3 1111111 1 111 111111=   1 
  1                             1 
  1   1       1     1       1   1 
  1   1       1     1       1   1 
  1   1       1     1       1   1 
  1   1       1     1       1   1 
  1   1                     1   1 
  1   1                     1   1 
  1   1 1111            11111   1 
  1                             1 
  1   1                     1   1 
  1   1                     1   1 
  1 111                     1 111 
                                  
  1   1 1111            11111   1 
  1                             1 
  1   1                     1   1 
  1   1                     1   1 
  1   1       1     1       1   1 
  1   1       1     1       1   1 
  1   1       1     1       1   1 
  1   1       1     1       1   1 
  1   : 1111111 1 111 1111113   1 
  1                             1 
  1             1               1 
  1             1               1 
  2 1111111111111 111111111111112 
                                  
*