Textures/grave2.bmp
12 10
5 10
0
       3002       
       1  1       
 F     1  1   F   
       1  1       
30000009D 80000002
1      1  1      1
1  E   1  1  E   1
800007060060700009
1    1      1    1
1    1 3002 1    1
80000:09  80:00009
1    1 1C 1 1    1
1    1 4005 1    1
1A   1      1  A 1
1    40000005    1
1                1
800007000000700009
1    1      1    1
800706700007607009
1  1  1    1  1  1
1  1F 1    1F 1  1
4005  1    1  4005
      1    1      
      400005      
*
              1 11111               
                                    
              1     1               
              1     1               
              1     1               
              1     1               
              1     1               
              1     1               
3 1111111111112     2 1111111111113 
                                    
1             1     1             1 
1             1     1             1 
1             1     1             1 
1             1     1             1 
1 111111111 111 11111 111 111111111 
                                    
1         1             1         1 
1         1             1         1 
1         1   1 11111   1         1 
1         1             1         1 
1 111111111 111     1 111 111111111 
                                    
1         1   1     1   1         1 
1         1   1     1   1         1 
1         1   1 11111   1         1 
1         1             1         1 
1         1             1         1 
1         1             1         1 
1         2 1111111111112         1 
1                                 1 
1                                 1 
1                                 1 
1 111111111 1111111111111 111111111 
                                    
1         1             1         1 
1         1             1         1 
1 11111 114 1 111111111 < 111 11111 
                                    
1     1     1         1     1     1 
1     1     1         1     1     1 
1     1     1         1     1     1 
1     1     1         1     1     1 
1 11112     1         1     2 11111 
            1         1             
            1         1             
            1         1             
            1 111111111             
                                    
*