Textures/classic4.bmp
8 4
8 6
0
300000707070000002
1     1 1 1      1
80002 40:05 300009
1   1   1   1    1
80006000:000600009
1       1        1
80007000:000700009
1   1   1   1    1
80005 30:02 400009
1     1 1 1      1
400000606060000005
*
2 11111111111 119 111 1111111111112 
                                    
1           1   1   1             1 
1           1   1   1             1 
1 1111114   1 111 111   3 111111111 
                                    
1       1       1       1         1 
1       1       1       1         1 
1 1111111 1111111 1111111 111111111 
                                    
1               1                 1 
1               1                 1 
1 1111111 1111111 1111111 111111111 
                                    
1       1       1       1         1 
1       1       1       1         1 
1 1111113   1 111 111   4 111111111 
                                    
1           1   1   1             1 
1           1   1   1             1 
2 11111111111 119 111 1111111111112 
                                    
*