Textures/grave2.bmp
5 3
12 3
1
30023002  30023002
1  11  1  1  11  1
1F 11  1B 1  11F 1
8006670:00:0766009
1    1 1  1 1    1
1B   1 1A 1 1 D  1
8007760:00:0677009
1  11  1  1  11  1
1F 11  1C 1  11F 1
40054005  40054005
                  
*
2 11111 1 11111     1 11111 1 11112 
                                    
1     1 1     1     1     1 1     1 
1     1 1     1     1     1 1     1 
1     1 1     1     1     1 1     1 
1     1 1     1     1     1 1     1 
5 11111 1 1 111 11111       1 11115 
                                    
1         1   1     1             1 
1         1   1     1             1 
1         1   1     1             1 
1         1   1     1             1 
1 11111 1 > 111 11111 11= 1 1 11111 
                                    
1     1 1     1     1     1 1     1 
1     1 1     1     1     1 1     1 
1     1 1     1     1     1 1     1 
1     1 1     1     1     1 1     1 
2 11111 1 11111     1 11111 1 11112 
                                    
                                    
                                    
*