Textures/desert2.bmp
8 13
8 9
1
                 
                 
                 
30000000700000002
1       1       1
1 300000:000002 1
1 1     1     1 1
80:02 C 1A  30:09
1 1 1   1   1 1 1
1 1 407060705 1 1
1 1   1   1   1 1
1 80009   80009 1
1 1   1D  1   1 1
1 1 306070602 1 1
1 1 1   1   1 1 1
80:05 A 1B  40:09
1 1     1     1 1
1 400000:000005 1
1       1       1
40000000600000005
*
                                  
                                  
                                  
                                  
                                  
                                  
2 111111111111111 111111111111112 
                                  
1               1               1 
1               1               1 
1   1 1111111111= 11111111111   1 
1                               1 
1   1           1           1   1 
1   1           1           1   1 
1 111 111       1       1 111 111 
                1                 
1   1   1       1       1   1   1 
1   1   1       1       1   1   1 
1   1   1 111 111 111 111   1   1 
1   1                       1   1 
1   1       1       1       1   1 
1   1       1       1       1   1 
1   3 1111111       1 1111114   1 
1                               1 
1   1       1       1       1   1 
1   1       1       1       1   1 
1   1   1 111 111 111 111   1   1 
1   1                       1   1 
1   1   1       1       1   1   1 
1   1   1       1       1   1   1 
1 111 111       1       1 111 111 
                1                 
1   1           1           1   1 
1   1           1           1   1 
1   1 1111111111: 11111111111   1 
1                               1 
1               1               1 
1               1               1 
2 111111111111111 111111111111112 
                                  
*