Textures/desert1.bmp
9 18
9 2
1
 30000070007000002
 1     1   1     1
 1     80009     1
 1 D   1   1 D   1
 807000:000:000709
 1 1   1   1   1 1
 1 1 A 1   1   1 1
 1 1   1   1C  1 1
 80:0005   4000:09
 1 1           1 1
 1 1           1 1
 1 1    D      1 1
 80:0002   3000:09
 1 1   1   1   1 1
 1 1   1   1   1 1
 1 1B  1   1A  1 1
 806000:000:000609
 1     1   1     1
 1     80009     1
 1 D   1   1 D   1
 40000060006000005
                  
                  
                  
                  
*
  2 11111111111 1131111 11111111112 
                                    
  1           1       1           1 
  1           1       1           1 
  1           1       1           1 
  1                               1 
  1           1       1           1 
  1           1       1           1 
  1 11> 1111111 1111111 111111; 111 
                                    
  1   1       1       1       1   1 
  1   1       1       1       1   1 
  1   1       1       1       1   1 
  1   1       1       1       1   1 
  1   1       1       1       1   1 
  1   1       1       1       1   1 
  1 111 1111116       5 1111111 111 
                                    
  1   1                       1   1 
  1   1                       1   1 
  1   1                       1   1 
  1   1                       1   1 
  1   1                       1   1 
  1   1                       1   1 
  1 111 1111115       6 1111111 111 
                                    
  1   1       1       1       1   1 
  1   1       1       1       1   1 
  1   1       1       1       1   1 
  1   1       1       1       1   1 
  1   1       1       1       1   1 
  1   1       1       1       1   1 
  1 11: 1111111 1111111 111111: 111 
                                    
  1           1       1           1 
  1           1       1           1 
  1           1 1111111           1 
  1                               1 
  1           1       1           1 
  1           1       1           1 
  2 11111111111 1131111 11111111112 
                                    
                                    
                                    
                                    
                                    
                                    
                                    
                                    
                                    
*