Textures/desert2.bmp
8 17
8 2
1
       3002       
    3009  8002    
    1  8009  1    
    1  1  1  1    
 3076076006706702 
 1 1  1    1  1 1 
 1 1A 1    1C 1 1 
 1 8005    4009 1 
 809          809 
 1 1          1 1 
 1 1          1 1 
 809   D      809 
 1 8002    3009 1 
 1 1  1    1  1 1 
 1 1B 1    1A 1 1 
 4067067007607605 
    1  1  1  1    
    1C 8009A 1    
    4009  8005    
       4005       
                  
                  
                  
                  
*
              1 11311               
                                    
        2 11111     1 11112         
                                    
        1     1     1     1         
        1                 1         
        1     1     1     1         
        1     1     1     1         
  1 11> 1 111 1 11111 1 111 ; 111   
                                    
  1   1     1         1     1   1   
  1   1     1         1     1   1   
  1   1     1         1     1   1   
  1   1     1         1     1   1   
  1   1 11116         5 11111   1   
  1                             1   
  1 111                     1 111   
                                    
  1   1                     1   1   
  1   1                     1   1   
  1   1                     1   1   
  1   1                     1   1   
  1 111                     1 111   
                                    
  1   1 11115         6 11111   1   
  1                             1   
  1   1     1         1     1   1   
  1   1     1         1     1   1   
  1   1     1         1     1   1   
  1   1     1         1     1   1   
  1 11: 1 111 1 11111 1 111 : 111   
                                    
        1     1     1     1         
        1     1     1     1         
        1     1 11111     1         
        1                 1         
        2 11111     1 11112         
                                    
              1 11311               
                                    
                                    
                                    
                                    
                                    
                                    
                                    
                                    
                                    
*
