Textures/classic9.bmp
11 11
6 8
0
                  
300000700007000002
1     1    1     1
1 3000:0000:0002 1
1 1   1    1   1 1
1 1 3062  3602 1 1
1 1 1  1  1  1 1 1
80:09 360062 80:09
1 1 409    805 1 1
1 1   1    1   1 1
1 1   1    1   1 1
1 1 309    802 1 1
80:09 470075 80:09
1 1 1  1  1  1 1 1
1 1 4075  4705 1 1
1 1   1    1   1 1
1 4000:0000:0005 1
1     1    1     1
400000600006000005
*
                                    
                                    
2 11111111111 111111111 11111111112 
                                    
1           1         1           1 
1           1         1           1 
1   3 1111111 111111111 111111=   1 
1                                 1 
1   1       1         1       1   1 
1   1       1         1       1   1 
1   1   5 111 1     1 1 114   1   1 
1   1                         1   1 
1   1   1     1     1     1   1   1 
1   1   1     1     1     1   1   1 
1 111 111                 1 111 111 
                                    
1   1   1 11            111   1   1 
1   1                         1   1 
1   1                         1   1 
1   1                         1   1 
1   1                         1   1 
1   1                         1   1 
1   1   1 11            111   1   1 
1   1                         1   1 
1 111 111                 1 111 111 
                                    
1   1   1     1     1     1   1   1 
1   1   1     1     1     1   1   1 
1   1   4 111 1     1 1 115   1   1 
1   1                         1   1 
1   1       1         1       1   1 
1   1       1         1       1   1 
1   > 1111111 111111111 1111113   1 
1                                 1 
1           1         1           1 
1           1         1           1 
2 11111111111 111111111 11111111112 
                                    
*