Textures/classic10.bmp
2 13
15 13
0
307000070070000702
1 1    1  1    1 1
1 1    1  1    1 1
805    1  1    409
1   3006006002   1
1   1        1   1
1   1        1   1
80009        80009
1   1        1   1
1   1        1   1
80709        80709
1 1 1        1 1 1
1 1 1        1 1 1
80609        80609
1   1        1   1
1   1        1   1
80009        80009
1   1        1   1
1   1        1   1
1   4007007005   1
802    1  1    309
1 1    1  1    1 1
1 1    1  1    1 1
406000060060000605
*
3 111 111111111 11111 111111111 113 
                                    
1   1         1     1         1   1 
1   1         1     1         1   1 
1   1         1     1         1   1 
1   1         1     1         1   1 
1 11=         1     1         : 111 
              1     1               
1       2 11111 11111 11112       1 
1                                 1 
1       1                 1       1 
1       1                 1       1 
1       1                 1       1 
1       1                 1       1 
1 1111111                 1 1111111 
                                    
1       1                 1       1 
1       1                 1       1 
1       1                 1       1 
1       1                 1       1 
1 111 111                 1 111 111 
                                    
1   1   1                 1   1   1 
1   1   1                 1   1   1 
1   1   1                 1   1   1 
1   1   1                 1   1   1 
                                    
                                    
1       1                 1       1 
1       1                 1       1 
1       1                 1       1 
1       1                 1       1 
1 1111111                 1 1111111 
                                    
1       1                 1       1 
1       1                 1       1 
1       1                 1       1 
1       1                 1       1 
1       2 11111 11111 11112       1 
1                                 1 
1 11:         1     1         = 111 
              1     1               
1   1         1     1         1   1 
1   1         1     1         1   1 
1   1         1     1         1   1 
1   1         1     1         1   1 
3 111 111111111 11111 111111111 113 
                                    
*