Textures/grave2.bmp
5 6
12 6
1
       3002       
 3002A 1  1A 3002 
 1  800:00:009  1 
 1E 1  1  1  1E 1 
 4705  1C 1  4075 
  1  309  802  1  
  8009 8009 8009  
  1  409  805  1  
 3602  1B 1  3062 
 1  1  1  1  1  1 
 1E 800:00:009E 1 
 4005  1  1  4005 
     A 4005A      
*
              4 1111>               
                                    
  2 11111     1     1     1 11112   
              1     1               
  1     1 11111 11111 11111     1   
  1                             1   
  1     1     1     1     1     1   
  1     1     1     1     1     1   
  1 1 115     1     1     5 111 1   
              1     1               
    1     1 111               1     
    1                         1     
    1 11111   1 1111=     11111     
                                    
    1     1 111               1     
    1                         1     
  1 1 115     1     1     5 111 1   
              1     1               
  1     1     1     1     1     1   
  1     1     1     1     1     1   
  1     1 11111 11111 11111     1   
  1                             1   
  2 11111     1     1     1 11112   
              1     1               
              : 11114               
                                    
*