Textures/classic7.bmp
10 12
6 12
1
30000700000700002 
1    1     1    1 
1 300602 306002 1 
1 1    1 1    1 1 
1 1    1 1    1 1 
809    809    809 
1 1    1 1    1 1 
1 1    1 1    1 1 
1 1 3009 8002 1 1 
1 1 1  1 1  1 1 1 
1 1 1 36062 1 1 1 
1 1 1 1   1 1 1 1 
80:0:09   80:0:09 
1 1 1 1   1 1 1 1 
1 1 1 47075 1 1 1 
1 1 1  1 1  1 1 1 
1 1 4009 8005 1 1 
1 1    1 1    1 1 
1 1    1 1    1 1 
809    809    809 
1 1    1 1    1 1 
1 1    1 1    1 1 
1 400705 407005 1 
1    1     1    1 
40000600000600005 
*
2 111111111 11111111111 111111112   
                                    
1         1           1         1   
1         1           1         1   
1   6 11111 111   1 111 11114   1   
1                               1   
1   1         1   1         1   1   
1   1         1   1         1   1   
1   1         1   1         1   1   
1   1         1   1         1   1   
1 111         1 111         1 111   
                                    
1   1         1   1         1   1   
1   1         1   1         1   1   
1   1         1   1         1   1   
1   1         1   1         1   1   
1   1   1 11111   1 11111   1   1   
1   1                       1   1   
1   1   1     1   1     1   1   1   
1   1   1     1   1     1   1   1   
1   1   1               1   1   1   
1   1   1               1   1   1   
1   1   1               1   1   1   
1   1   1               1   1   1   
1 11> 111               1 11= 111   
                                    
1   1   1               1   1   1   
1   1   1               1   1   1   
1   1   1               1   1   1   
1   1   1               1   1   1   
1   1   1     1   1     1   1   1   
1   1   1     1   1     1   1   1   
1   1   1 11111   1 11111   1   1   
1   1                       1   1   
1   1         1   1         1   1   
1   1         1   1         1   1   
1   1         1   1         1   1   
1   1         1   1         1   1   
1 111         1 111         1 111   
                                    
1   1         1   1         1   1   
1   1         1   1         1   1   
1   1         1   1         1   1   
1   1         1   1         1   1   
1   3 11111 111   1 111 11115   1   
1                               1   
1         1           1         1   
1         1           1         1   
2 111111111 11111111111 111111112   
                                    
*