Textures/classic2.bmp
10 5
6 5
1
 300700070000702  
 1  1   1    1 1  
 8009 30602 3609  
 1  1 1   1 1  1  
 1  1 1   1 1  1  
 80760:000:0:009  
 1 1  1   1 1  1  
 1 1  1   1 1  1  
 8062 40705 4709  
 1  1   1    1 1  
 400600060000605  
*
  2 11111 1111111 111111111 112     
                                    
  1     1       1         1   1     
  1     1       1         1   1     
  1 1111>   1 111 111   1 1 111     
                                    
  1     1               1     1     
  1     1               1     1     
  1     1               1     1     
  1     1               1     1     
  1 111 1 11        1 111 11111     
                                    
  1   1                 1     1     
  1   1                 1     1     
  1   1                 1     1     
  1   1                 1     1     
  1 113 1   1 111 111   1 6 111     
                                    
  1     1       1         1   1     
  1     1       1         1   1     
  2 11111 1111111 111111111 112     
                                    
*