Textures/classic3.bmp
0 5
17 5
1
    3000000002    
    1        1    
3000:07000070:0002
1   1 1    1 1   1
1   1 1    1 1   1
80009 1    1 80009
1   1 1    1 1   1
1   1 1    1 1   1
4000:06000060:0005
    1        1    
    4000000005    
*
        1 11111111:11111113         
                                    
        1                 1         
        1                 1         
1 1111112 111 111111111 111       6 
                                    
1       1   1         1   1         
1       1   1         1   1         
1       1   1         1   1         
1       1   1         1   1         
1 1111111   1         1   1         
            1         1             
1       1   1         1   1         
1       1   1         1   1         
1       1   1         1   1         
1       1   1         1   1         
1 1111111 111 111111111 112       6 
                                    
        1                 1         
        1                 1         
        3 11111111>11111111         
                                    
*