Textures/grave2.bmp
5 7
12 7
1
300770070070077002
1  11  1  1  11  1
1F 11  1B 1  11F 1
80054009  80054009
80023009  80023009
1  11  1  1  11  1
1  11  1  1  11  1
800667060060766009
1    1      1    1
1 D  1  A   1 D  1
800776070070677009
1  11  1  1  11  1
1  11  1  1  11  1
80054009  80054009
80023009C 80023009
1  11  1  1  11  1
1F 11  1  1  11F 1
400660060060066005
*
2 11111 1 11114 11111 11111 1 11112 
                                    
1     1       1     1       1     1 
1     1       1     1       1     1 
1     1       1     1       1     1 
1     1       1     1       1     1 
1 11111       1     1       1 11111 
                                    
1       1 11111     1 11111       1 
                                    
1       1     1     1     1       1 
1       1     1     1     1       1 
1       1     1     1     1       1 
1       1     1     1     1       1 
5 11111 1 1 111 11111       1 11115 
                                    
1         1                       1 
1         1                       1 
1         1                       1 
1         1                       1 
1 11111 1 > 111 11111 11= 1 1 11111 
                                    
1       1     1     1     1       1 
1       1     1     1     1       1 
1       1     1     1     1       1 
1       1     1     1     1       1 
1       1 11111     1 11111       1 
                                    
1 11111       1     1       1 11111 
                                    
1     1       1     1       1     1 
1     1       1     1       1     1 
1     1       1     1       1     1 
1     1       1     1       1     1 
2 11111 1 11114 11111 11111 1 11112 
                                    
*