Textures/town2.bmp
10 12
7 7
1
                  
    3002  3002    
    1  8009  1    
 C  1  1  1  1 L  
  306009H 80060002
  1    1  1      1
  1G E 1  1E G   1
30600705  40700009
1    1      1    1
1    1      1    1
1 B  1      1 K  1
407009 A    800705
  1  402  305  1  
  1H   1  1  H 1  
  407009  800705  
    1  1  1  1    
    1F 1G 1F 1    
 I  4006006005 J  
                  
*
                                    
                                    
        2 11111     1 11112         
                                    
        1       11=11     1         
        1                 1         
        1           1     1         
        1           1     1         
    1 111 1111      1 11111 1111113 
                                    
    1               1             1 
    1               1             1 
    1               1             1 
    1               1             1 
3 111 11111         1 111 111111111 
                                    
1         1             1         1 
1         1             1         1 
1         1             1         1 
1         1             1         1 
1         1             1         1 
1         1             1         1 
1 113 11111             1 11113 111 
                                    
    1     1 111     1 111     1     
    1                         1     
    1         1     1         1     
    1         1     1         1     
    1 112 11111     1 11112 111     
                                    
        1     1     1     1         
        1     1     1     1         
        1     1     1     1         
        1     1     1     1         
        1 11111 1>111 11111         
                                    
                                    
                                    
*