Textures/grave2.bmp
8 0
8 111
0
     3007002      
     1  1  1      
     8B 1D 1      
     400:005      
        1         
        1         
        1         
  3000706070002   
  1   1   1   1   
F 1 A 1   1A  1 F 
  1  3600062  1   
  8009     8009   
F 1  1  C  1  1 F 
  1  1     1  1   
  8009     8009   
F 1  4700075  1 F 
  1A  1   1 A 1   
  1   1   1   1   
F 4707600067075 F 
   1 1     1 1    
   1 1  C  1 1    
   1 1     1 1    
300:09     80:002 
1  1 4070705 1  1 
1  1   1 1   1  1 
8009   1 1   8009 
1  40709 80705  1 
1E   1 1 1 1  B 1 
1    1 1 1 1    1 
8000760:0:0670009 
1   1  1 1  1   1 
1   1B 1 8D 1   1 
40706009 80060705 
  1    1 1    1   
  1 F  1 1  F 1   
30670076067007602 
1  1  1   1  1  1 
1E 1  1C  1  1A 1 
8009  1   8006009 
1  800:0009     1 
8009  1   8007009 
1  1  1B  1  1  1 
1F 1  1   1  1F 1 
40067060706076005 
    1   1   1     
F   1D  1 B 1   F 
    1   1   1     
  306000:00062    
  1     1    1    
  1C    1  C 1    
  1     1    1    
  800070607009    
  1   1   1  1    
  1 F 1 B 1F 1    
  1   80009  1    
  80009   8009    
  1   1   1  1    
  1   1 C 1  1    
  1   1   1  1    
  407060706075    
    1   1   1     
  F 80009   1 F   
    1   80009     
    1   1   1     
3000:000:000:0002 
1   1   1   1   1 
1F  8000:0009 E 1 
80009   1   80009 
1   1 F 1 A 1   1 
8000:0006000:0009 
1   1       1   1 
1   1       1   1 
1   1 D   F 1   1 
80009       80009 
1   1   C   1   1 
1   1 F   D 1   1 
1   1       1   1 
80006007070060009 
1      1 1      1 
1  A   1 1   A  1 
40700705 40700705 
  1  1     1  1   
  1  1     1  1   
  1  8007009  1   
  4075  1  4705   
    1   1   1     
30009 F 1 F 80002 
1   1   1   1   1 
80006070607060009 
1     1   1     1 
1 D   1   1  D  1 
80070060706007009 
1  1    1    1  1 
1F 1    1    1F 1 
1  1 B  1 B  1  1 
80060070:07006009 
1     1 1 1     1 
1   D 80:09 B   1 
8002  1 1 1  3009 
1  1  1 1 1  1  1 
1  80060:06009  1 
1  1    1    1  1 
1  1    1    1  1 
40067000600076005 
    1       1     
    1   A   1     
    4000;0005     
        1         
     F  1 F       
        1         
     F  1 F       
        1         
*
          1 11111 11111             
                                    
          1     1     1             
          1     1     1             
          1     1     1             
                1     1             
          1 11111 11111             
                                    
                1                   
                1                   
                1                   
                1                   
                1                   
                1                   
    2 1111111 111 111 1111115       
                                    
    1       1       1       1       
    1       1       1       1       
    1       1       1       1       
    1       1       1       1       
    1     4 1 1111111 3     1       
    1                       1       
    1 11111           1 11111       
                                    
    1     1           1     1       
    1     1           1     1       
    1     1           1     1       
    1     1           1     1       
    1 11111           1 11111       
                                    
    1     3 1 1111111 4     1       
    1                       1       
    1       1       1       1       
    1       1       1       1       
    1       1       1       1       
    1       1       1       1       
    5 1 111 1 1111111 1 111 2       
                                    
      1   1           1   1         
      1   1           1   1         
      1   1           1   1         
      1   1           1   1         
      1   1           1   1         
      1   1           1   1         
1 11111 111           1 111 11111   
                                    
1     1   1 111 111 111   1     1   
1     1                   1     1   
1     1       1   1       1     1   
1     1       1   1       1     1   
1 11111       1   1       1 11111   
              1   1                 
1     7 111 111   1 111 118     1   
1                               1   
1         1   1   1   1         1   
1         1   1   1   1         1   
1         1   1   1   1         1   
1         1   1   1   1         1   
6 1111111 1 111 111 111 1 1111116   
                                    
1       1     1   1     1       1   
1       1     1   1     1       1   
1       1     1   1     1       1   
1       1     1         1       1   
2 111 111 11111   1 11111 111 112   
                                    
    1         1   1         1       
    1         1   1         1       
    1         1   1         1       
    1         1   1         1       
1 111 1 11111 1 111 1 11111 1 111   
                                    
1     1     1       1     1     1   
1     1     1       1     1     1   
1     1     1       1     1     1   
1     1     1       1     1     1   
1 11111     1       1 11111 11111   
            1                       
1     1 11111 1111111           1   
1                               1   
6 11111     1       1 11111 11113   
            1                       
1     1     1       1     1     1   
1     1     1       1     1     1   
1     1     1       1     1     1   
1     1     1       1     1     1   
1 11111 1 111 111 111 111 1 11111   
                                    
        1       1       1           
        1       1       1           
        1       1       1           
        1       1       1           
        1       1       1           
        1       1       1           
    1 111 111111; 1111111 1         
                                    
    1           1         1         
    1           1         1         
    1           1         1         
    1           1         1         
    1           1         1         
    1           1         1         
    1 1111111 111 111 11111         
                                    
    1       1       1     1         
    1       1       1     1         
    1       1       1     1         
    1       1       1     1         
    1       1 1111111     1         
    1                     1         
    1 1111111       1 11111         
                                    
    1       1       1     1         
    1       1       1     1         
    1       1       1     1         
    1       1       1     1         
    1       1       1     1         
    1       1       1     1         
    6 111 111 11> 111 111 5         
                                    
        1       1       1           
        1       1       1           
        1 1111111       1           
                        1           
        1       1 1111111           
        1                           
        1       1       1           
        1       1       1           
4 1111111 1111111 1111111 1111111   
                                    
1       1       1       1       1   
1       1       1       1       1   
1       1 1111111 1111111       1   
1                               1   
1 1111111       1       1 1111111   
                1                   
1       1       1       1       1   
1       1       1       1       1   
1 1111111 111 111 1111111 1111115   
                                    
1       1               1       1   
1       1               1       1   
1       1               1       1   
1       1               1       1   
        1               1       1   
1       1               1       1   
1 1111111               1 1111111   
                                    
1       1               1       1   
1       1               1       1   
1       1               1       1   
1       1               1       1   
1       1               1       1   
1       1               1       1   
1 1111111 11111 111 11111 1111111   
                                    
1             1   1             1   
1             1   1             1   
1             1   1             1   
1             1   1             1   
1 111 11111 111   1 111 11111 111   
                                    
    1     1           1     1       
    1     1           1     1       
    1     1           1     1       
    1     1           1     1       
    1     1 11111 11111     1       
    2                       2       
    1 111 1     1     1 1 111       
                1                   
        1       1       1           
        1       1       1           
1 1111111       1       1 1111111   
                1                   
1       1       1       1       1   
1       1       1       1       1   
1 1111111 111 111 111 111 1111111   
                                    
1           1       1           1   
1           1       1           1   
1           1       1           1   
1           1       1           1   
1 11111 11111 111 111 11111 11111   
                                    
1     1         1         1     1   
1     1         1         1     1   
1     1         1         1     1   
1     1         1         1     1   
1     1         1         1     1   
1     1         1         1     1   
4 11111 11111 113 111 11111 11114   
                                    
1           1   1   1           1   
1           1   1   1           1   
1           1 111 111           1   
1                               1   
1 11111     1   1   1     1 11111   
            1   1   1               
1     1     1   1   1     1     1   
1     1     7   1   8     1     1   
1     1 11111 111 111 11111     1   
1                               1   
1     1         1         1     1   
1     1         1         1     1   
1     1         1         1     1   
1     1         1         1     1   
1 11111 1 1111115 1111111 1 11111   
                                    
        1               1           
        1               1           
        1               1           
        1               1           
        1 111111  1111111           
                                    
                                    
                                    
                                    
                                    
                                    
                                    
                                    
                                    
                                    
                                    
*