Textures/garden2.bmp
8 0
8 126
0
    30000002      
    1      1      
    1B  C  1      
30009      80002  
1   1      1   1  
1   1  D   1   1  
1   80007009   1  
80009   1  80009  
1   1   1  1   1  
1A  1   1  1 I 1  
47006000:0060075  
 1      1     1   
 1      1  B  1   
 1E   H 1     1   
 1  300060002 1   
 1  1       1 1   
 8009B    C 809   
 1  1       1 1   
 1  1   D   1 1   
 1  400070005 1   
 1      1     1   
 40700076700075   
   1   1 1   1    
   1C  1 1 C 1    
 F 40705 40705G   
     1     1      
     1  H  1      
30000:00000:000002
1    1     1     1
1B 309  D  8002B 1
1  1 8007009  1  1
8005 1  1  1  4009
1    1F 1E 1     1
1    1  1  1     1
407005  1  4007005
  1     1     1   
  8000006000009 I 
  1           1   
  8002C  C 3009   
  1  1     1  1   
  1  1  D  1  8002
  1  4000005  1  1
  1           1\ 1
  4070007000706009
    1   1   1    1
    1   1   1    1
3000602 1 30600009
1     1 1 1      1
1B  C 1 1 1B  D  1
8007009 1 80007009
1  1  1 1 1   1  1
1X 1J 1 1 1   1X 1
1  800:0:0:0009  1
1V 1  1 1 1   1V 1
40062 1 1 1 306005
    1 40:05 1     
 H  1   1   1 G   
    1   1   1     
 3006000:0006002  
 1      1      1  
 1  D   1  L   1  
 1      1      1  
 8000000:0000009  
 1      1      1  
 1B   C 1C   B 1  
 1      1      1  
 4007000:0007005  
    1   1   1     
    1H  1G  1     
 3006000:0006002  
 1      1      1  
 1Y Z [ 1Y Z [ 1  
 800007060700009  
 1    1   1    1  
 1 B  1C  1 B  1  
 1    1   1    1  
 800009   800009  
 1  305   402  1  
 1X 1       1X 1  
 1  1       1  1  
 1V 1  F    1V 1  
 400:0700070:005  
    1 1   1 1     
    1 1   1 1     
30009 1   1 800002
1   1 1   1 1    1
1B  40:000:05 C  1
1     1   1      1
8000009   80000009
1     1   1      1
1 K   1   1 D    1
400000:000:0000005
      1   1       
  30009 C 80002   
  1   1   1   1   
  1E  1   1 F 1   
  80009   80009   
  1   1J  1   1   
  1   1   1   1   
  1 G 1   1H  1   
 360006070600062  
 1      1      1  
 1Y Z [ 1Y Z [ 1  
 400700060007005  
    1       1     
    1B    B 1     
    800000009     
    1       1     
30009  C    80002 
1   1       1   1 
1H  1       1 F 1 
1   1D    I 1   1 
1 3060000000602 1 
1 1           1 1 
1 1C  B   B C 1 1 
80600000700000609 
1       1       1 
80000700600700009 
1    1     1    1 
1S U 1     1S U 1 
1    1     1    1 
1M O 1     1M O 1 
40000600;00600005 
        1         
        1         
        1         
        1         
*
        1 1111111111111             
                                    
        1             1             
        1             1             
        1             1             
        1             1             
1 1111111             1 1111111     
                                    
1       1             1       1     
1       1             1       1     
1       1             1       1     
1       1             1       1     
1       1 1111111 11111       1     
1                             1     
1 1111111       1     1 1111111     
                1                   
1       1       1     1       1     
1       1       1     1       1     
1       1       1     1       1     
1       1       1     1       1     
1 1 11111 1111112 11111 11111 1     
                                    
  1             1           1       
  1             1           1       
  1             1           1       
  1             1           1       
  1             1           1       
  1             1           1       
  1     1 1111111 1111111   1       
  1                         1       
  1     1               1   1       
  1     1               1   1       
  1 11511               1 511       
                                    
  1     1               1   1       
  1     1               1   1       
  1     1               1   1       
  1     1               1   1       
  1     1 1111111 1111111   1       
  1                         1       
  1             1           1       
  1             1           1       
  1 111 1111111 1 1 1111111 1       
                                    
      1       1   1       1         
      1       1   1       1         
      1       1   1       1         
      1       1   1       1         
      1 11> 111   1 11< 111         
                                    
          1           1             
          1           1             
          1           1             
          1           1             
1 111111111 11111111111 11111111111 
                                    
1         1           1           1 
1         1           1           1 
1     1 111           1 11111     1 
1                                 1 
1     1   1 11111 11111     1     1 
1     1                     1     1 
1 11111   1     1     1     1 11111 
          1     1     1             
1         1     1     1           1 
1         1     1     1           1 
1         1     1     1           1 
1         1     1     1           1 
1 118 11111     1     1 1111: 11111 
                1                   
    1           1           1       
    1           1           1       
    1 11111111111 11111111111       
                                    
    1                       1       
    1                       1       
    1 11111           1 11111       
                                    
    1     1           1     1       
    1     1           1     1       
    1     1           1     1 11112 
    1     1           1             
    1     1 11111711111     1     1 
    1                       1     1 
    1                       1     1 
    1                       1     1 
    1 113 1111111 1111111 116 11111 
                                    
        1       1       1         1 
        1       1       1         1 
        1       1       1         1 
        1       1       1         1 
1 1111111 111   1   1 111 111111111 
                6                   
1           1   1   1             1 
1           1   1   1             1 
1           1   1   1             1 
1           1   1   1             1 
1 11111 11111   1   1 1111111 11111 
                1                   
1     1     1   1   1       1     1 
1     1     1   1   1       1     1 
1     1     1   4   1       1     1 
1     1     1   1   1       1     1 
1     1 11111 111 111 1111111     1 
1                                 1 
1     1     1   1   1       1     1 
1     1     1   1   1       1     1 
1 11111 1   1   1   1   1 111 11111 
            1   1   1               
        1   1 111 111   1           
        1               1           
        1       1       1           
        1       1       1           
        1       1       1           
        1       1       1           
  2 11111 1111111 1111111 11111     
                                    
  1             1             1     
  1             1             1     
  1             1             1     
  1             1             1     
  1             1             1     
  1             1             1     
  1 111111111111< 1111111111111     
                                    
  1             1             1     
  1             1             1     
  1             1             1     
  1             1             1     
  1             1             1     
  1             1             1     
  1 11111 1111111 1111111 11113     
                                    
        1       1       1           
        1       1       1           
        1       1       1           
        1       1       1           
  1 11111 1111111 1111111 11111     
                                    
  1             1             1     
  1             1             1     
  1             1             1     
  1             1             1     
  6 111111111 111 111 111111116     
                                    
  1         1       1         1     
  1         1       1         1     
  1         1       1         1     
  1         1       1         1     
  1         1       1         1     
  1         1       1         1     
  1 111111111       1 111111111     
                                    
  1     1 111       1 111     1     
  1                           1     
  1     1               1     1     
  1     1               1     1     
  1     1               1     1     
  1     1               1     1     
  1     1               1     1     
  1     1               1     1     
  1 11111 111 1118111 111 11111     
                                    
        1   1       1   1           
        1   1       1   1           
        1   1       1   1           
        1   1       1   1           
1 1111111   1       1   1 111131111 
            1       1               
1       1   1       1   1         1 
1       1   1       1   1         1 
1       1 111 1111111 111         1 
1                                 1 
1           1       1             1 
4           1       1             2 
1 11111111111       1 1111111111111 
1                   1               
1           1       1             1 
1           1       1             1 
1           1       1             1 
1           1       1             1 
1 11113111111 1111111 1111111111111 
                                    
            1       1               
            1       1               
    1 1111111       1 1111111       
                                    
    1       1       1       1       
    1       1       1       1       
    1       1       1       1       
    1       1       1       1       
    1 1111111       1 1111111       
                                    
    1       1       1       1       
    1       1       1       1       
    1       1       1       1       
    1       1       1       1       
    1       1       1       1       
    1       1       1       1       
  1 1 1111111 111 111 1111111 1     
                                    
  1             1             1     
  1             1             1     
  1             1             1     
  1             1             1     
  1 11111 111111: 1111111 11111     
                                    
        1               1           
        1               1           
        1               1           
        1               1           
        1 111111111111111           
                                    
        1               1           
        1               1           
5 1111111               1 1111114   
                                    
1       1               1       1   
1       1               1       1   
1       1               1       1   
1       1               1       1   
1       1               1       1   
1       1               1       1   
1   1 111 111111111111111 111   1   
1                               1   
1   1                       1   1   
1   1                       1   1   
1   1                       1   1   
1   1                       1   1   
1 111 11111111111111111111111 111   
                1                   
1               1               1   
1               1               1   
1 111111111 11111111111 111111111   
                                    
1         1           1         1   
1         1           1         1   
1         1           1         1   
1         1           1         1   
1         1           1         1   
1         1           1         1   
1         1           1         1   
1         1           1         1   
1 111111111 1111  11111 111111111   
                                    
                                    
                                    
                                    
                                    
                                    
                                    
                                    
                                    
*