Textures/garden2.bmp
8 0
8 124
0
  300000000002    
  1          1    
  1Y Z Z Z [ 1    
  400700007005    
     1    1       
 30009 D  800002  
 1   1    1    1  
 1 B 400705B C 1  
 1      1      1  
 1      1      1  
 400700060007005  
    1       1     
    1G  I H 1     
    470070075     
     1  1  1      
     1  1  1      
 3007600:00:000002
 1  1   1  1     1
 47060076009C B  1
  1    1   1     1
  1D 30:000:000075
  1  1 1   1    1 
  8005 1 E 800009 
  1    1   1    1 
  1C   1 H 1Y [ 1 
  40000:000:00005 
       1   1      
 300700600062     
 1  1       8002  
 1\ 1 B C B 1  1  
 47067000000:005  
  1  1      1     
  1\ 1      1     
  8009      1     
  1  1      8002  
  1  1      1  1  
  1  1      1\ 1  
  40067000076009  
      1    1   1  
      1 D  1C  1  
   3006070067005  
   1    1   1     
   1Y [ 1 B 1     
   8070060706002  
   1 1    1    1  
   1 1C C 1S U 802
   1 1    1    1 1
   1 1 D  1M O 1 1
  3606070060700:09
  1    1    1  1 1
  1S U 1 K  1X 1 1
  1    1    1  809
  1M O 1E F 1W 1 1
  40700:00009  1 1
    1  1    1V 1 1
    1  80000600:09
 300:009       1 1
 1  1  1J    K 1 1
 1D 1J 80070700:05
 8006009  1 1  1  
 1     1  1 1\ 1  
 1C B  1  80:009  
 1     1  1 1  1  
 1  F  1  1 1\ 1  
 800007600:06075  
 1    1   1   1   
 1S U 1 C 1B  1   
 1    1   1   1   
 1M O 800060009   
3600009       1   
1     1 C A C 1   
1C  B 1       1   
1     1    K  1   
1     1 I     1   
1G  H 1       1   
800700600700706002
1  1     1  1    1
1X 1B  B 1X 1S U 1
1  1     1  1    1
1V 1     1V 1M O 1
800:00007600607009
1  1    1     1  1
1  1S U 1 I   1  1
4009    1     1  1
   1P R 1     1  1
   1    1   J 1  1
   1M O 8070076009
300600705 1  1   1
1     1   1C 1 B 1
1     1 B 1  1   1
1     4000:0060705
80002     1    1  
1   1     1 C  1  
1C  8000009    1  
1   1     1    1  
1   1E F  1G H 1  
4070600070600705  
  1     1    1    
  1     1Y [ 1    
  1     80000:0002
  1     1    1   1
  1     1    1 J 1
  470070600709   1
   1  1    1 80009
   1  1S U 1 1   1
   1  1    1 1K  1
   1  1M O 1 1   1
   80060000:060009
   1       1     1
   1B  C B 1     1
300607007009     1
1    1  1  1     1
1Y [ 1  1  1     1
40700:00600:007005
  1  1     1  1   
  1  1  D  1  1   
  4009     8005   
     1     1      
     1C  C 1      
     400;005      
        1         
        1         
        1         
        1         
        1         
*
    1 111111111111111111111         
                                    
    1                     1         
    1                     1         
    1                     1         
    1                     1         
    1 11111 111111111 11111         
                                    
          1         1               
          1         1               
  1 1111111         1 111111114     
                                    
  1       1         1         1     
  1       1         1         1     
  1       1 11111 111         1     
  1                           1     
  1             1             1     
  1             1             1     
  1             1             1     
  1             1             1     
  3 11111 1111111 1111111 11111     
                                    
        1               1           
        1               1           
        1               1           
        1               1           
        1 1 11112 11111 1           
                                    
          1     1     1             
          1     1     1             
          1     1     1             
          1     1     1             
  1 11111 1 11111 11111 11111111111 
                                    
  1     1       1     1           1 
  1     1       1     1           1 
  1 1 111 11111 1 11111           1 
                                  1 
    1         1       1           1 
    1         1       1           1 
    1     1 111 1111111 111111111 1 
    1                               
    1     1   1       1         1   
    1     1   1       1         1   
    8 11111   1       1 111111117   
              1                     
    1         1       1         1   
    1         1       1         1   
    1         1       1         1   
    1         1       1         1   
    1 111111111 1111111 111111111   
                                    
              1       1             
              1       1             
  1 11111 11111 1111111 1           
                                    
  1     1               1 11111     
  1     1                           
  1     1               1     1     
  1     1               1     1     
  1 1 111 1 1111111111111 11111     
                                    
    1     1             1           
    1     1             1           
    1     1             1           
    1     1             1           
    1 1111:             1           
                        1           
    1     1             : 11116     
    1     1                         
    1     1             1     1     
    1     1             1     1     
    1     1             1     1     
    1     1             1     1     
    3 11111 1 111111111 1 11111     
                                    
            1         1       1     
            1         1       1     
            1         1       1     
            1         1       1     
      5 11111 111 11111 1 11111     
                                    
      1         1       1           
      1         1       1           
      1         1       1           
      1         1       1           
      1 111 11112 111 111 11111     
                                    
      1   1         1         1     
      1   1         1         1     
      1   1         1         1 114 
      1   1         1               
      1   1         1         1   1 
      1   1         1         1   1 
      1   1         1         1   1 
      1   1         1         1   1 
    1 1 111 111 11111 111 11111 111 
                                    
    1         1         1     1   1 
    1         1         1     1   1 
    1         1         1     1   1 
    1         1         1     1   1 
    1         1         1     1 111 
    1         1         1           
    1         1         1     1   1 
    1         1         1     1   1 
    3 111 11111 111111111     1   1 
                              1   1 
        1     1         1     1   1 
        1     1         1     1   1 
        1     1 111111111 1111: 111 
        1                           
  1 11114 11111               1   1 
                              1   1 
  1     1     1               1   1 
  1     1     1               1   1 
  1     1     1 11111 111 11111 111 
  1     1                           
  1 11111 11111     1   1     1     
                    1   1     1     
  1           1     1   1     1     
  1           1     1   1     1     
  1           1     1 111 11111     
  1           1                     
  1           1     1   1     1     
  1           1     1   1     1     
  1           1     1   1     1     
  1           1     1   1     1     
  6 111111111 1 11111 111 111 1     
                                    
  1         1       1       1       
  1         1       1       1       
  1         1       1       1       
  1         1       1       1       
  1         1       1       1       
  1         1       1       1       
  1         1 111111= 1111111       
  1                                 
1 1 111111111               1       
                            1       
1           1               1       
1           1               1       
1           1               1       
1           1               1       
1           1               1       
1           1               1       
1           1               1       
1           1               1       
1           1               1       
1           1               1       
1 11111 11113 11111 11111 115 11111 
                                    
1     1           1     1         1 
1     1           1     1         1 
1     1           1     1         1 
1     1           1     1         1 
1     1           1     1         1 
1     1           1     1         1 
1     1           1     1         1 
1     1           1     1         1 
7 11111 111111111 1 11111 111 11118 
                                    
1     1         1           1     1 
1     1         1           1     1 
1     1         1           1     1 
1     1         1           1     1 
1 11111         1           1     1 
                1           1     1 
      1         1           1     1 
      1         1           1     1 
      1         1           1     1 
      1         1           1     1 
      1         1 111 11111 1 11116 
      1                             
1 11113 11111 111   1     1       1 
                    1     1       1 
1           1       1     1       1 
1           1       1     1       1 
1           1       1     1       1 
1           1       1     1       1 
1           1 1111115 11111 111 111 
1                                   
7 1111116           1         1     
                    1         1     
1       1           1         1     
1       1           1         1     
1       4 11111111111         1     
5                             1     
1       1           1         1     
1       1           1         1     
1       1           1         1     
1       1           1         1     
2 111 113 1111111 11< 11111 111     
                                    
    1           1         1         
    1           1         1         
    1           1         1         
    1           1         1         
    1           1 111111111 1111111 
    1                               
    1           1         1       1 
    1           1         1       1 
    1           1         1       1 
    1           1         1       1 
    1 1 11111 111 11113 111       1 
                                  1 
      1     1         1   1 1111111 
      1     1         1             
      1     1         1   1       1 
      1     1         1   1       1 
      1     1         1   1       1 
      1     1         1   1       1 
      1     1         1   1       1 
      1     1         1   1       1 
      : 11111 111111111 111 1111111 
                                    
      1               1           1 
      1               1           1 
      1               1           1 
      1               1           1 
1 11111 111 11111 11111           1 
                                  1 
1         1     1     1           1 
1         1     1     1           1 
1         1     1     1           1 
1         1     1     1           1 
3 111 11111 11111 11111 11111 11113 
                                    
    1     1           1     1       
    1     1           1     1       
    1     1           1     1       
    1     1           1     1       
    4 11111           1 11114       
                                    
          1           1             
          1           1             
          1           1             
          1           1             
          1 11111 11111             
                                    
                                    
                                    
                                    
                                    
                                    
                                    
                                    
                                    
                                    
                                    
*