Textures/town1.bmp
11 0
8 86
0
      30000702    
      1    1 1    
      1    1 1    
   B  1 C  1 8002 
  307060000675  1 
  1 1       1 G 1 
  1 1G H G  1   1 
  806070007060009 
  1   1   1     1 
  1   1F  1     1 
  400760706007005 
     1  1    1    
     1F 1  G 1    
  D  1  1    1    
30000600:0700602  
1       1 1    1  
1H    G 1 1    1  
80700700:09 I  1  
1 1  1  1 1    1  
1 1  1  1 8070062 
80600600:05 1   1 
1       1   1   1 
1       1G  1   1 
47007000600060705 
 1  1         1   
 1F 1         1   
 1  1 J  L  E 1   
 80060070000709   
 1     1    1 1   
 1     1 H  1 1   
 1B    1    1 1   
 400700:0000609   
    1  1      1   
    1  1  G   1   
    800:0700006002
 K  1  1 1       1
    1  1 1  E    1
    80060:00700075
    1    1  1   1 
  E 1    1  1   1 
    1 I  80060009 
    1    1      1 
    40700670002 1 
      1   1   1 1 
      1G  1 G 809 
      4700:0005 1 
 A     1  1     1 
       1  1     1 
 3000706006070075 
 1   1      1  1  
 1H  1F G F 1  1  
 1   1      1  1  
 8000:0007009  1  
 1   1   1  1  1  
 1F  1 E 8006009  
 1   1   1     1  
360006000:007005  
1        1  1     
1G  F  G 1  1     
400070070600600002
    1  1         1
    1  1H      H 1
    8009   D     1
    1  1         1
307060760700700709
1 1   1  1  1  1 1
1 1   400:005  1 1
1 1      1     1 1
809    F 1  F  809
1 8000700:007009 1
1 1   1  1  1  1 1
1 1   1G 1G 1  1 1
40:000600:00600:05
  1      1     1  
  1  H   1  F  1  
306707000600707602
1  1 1      1 1  1
1E 1 1  G   1 1  1
4075 47000705 4705
  1   1   1    1  
  1   1   1    1  
  1   1 E 1    1  
  400060;0600005  
        1         
        1         
        1         
   A    1 A       
*
            1 111111111 111         
                                    
            1         1   1         
            1         1   1         
            1         1   1         
            1         1   1         
            1         1   1 11111   
            1         1             
    1 111 111 111111111 1 1     1   
                                1   
    1   1               1       1   
    1   1               1       1   
    1   1               1       1   
    1   1               1       1   
    1 111 111 1111111 111 1111111   
                                    
    1       1       1           1   
    1       1       1           1   
    1       1       1           1   
    1       1       1           1   
    1 11111 1 111 11; 11111 11111   
                                    
          1     1         1         
          1     1         1         
          1     1         1         
          1     1         1         
          1     1         1         
          1     1         1         
1 111111114 11111 111 11111 111     
                                    
1               1   1         1     
1               1   1         1     
1               1   1         1     
1               1   1         1     
1 111 11111 11111 111         1     
                              1     
1   1     1     1   1         1     
1   1     1     1   1         1     
1   1     1     1   1 111 11111 1   
1   1     1     1                   
1 111 11111 11111 111   1       1   
                        1       1   
1               1       1       1   
1               1       1       1   
1               1       1       1   
1               1       1       1   
1 1 11112 1111111 1111111 115 111   
                                    
  1     1                   1       
  1     1                   1       
  1     1                   1       
  1     1                   1       
  1     1                   1       
  1     1                   1       
  1 11111 11111 111111111 111       
                                    
  1           1         1   1       
  1           1         1   1       
  1           1         1   1       
  1           1         1   1       
  1           1         1   1       
  1           1         1   1       
  3 11111 11111 111111111 111       
                                    
        1     1             1       
        1     1             1       
        1     1             1       
        1     1             1       
        1 11111 111 111111111 11111 
                                    
        1     1   1               1 
        1     1   1               1 
        1     1   1               1 
        1     1   1               1 
        5 11111 111 11111 111111> 1 
                                    
        1         1     1       1   
        1         1     1       1   
        1         1     1       1   
        1         1     1       1   
        1         1 11111 1111111   
        1                           
        1         1             1   
        1         1             1   
        1 111 1111B 1 1111111   1   
                                1   
            1       1       1   1   
            1       1       1   1   
            1       1       1 111   
            1       1               
            1 1 11111 1111111   1   
                                1   
              1     1           1   
              1     1           1   
              1     1           1   
              1     1           1   
  1 1111111 111 11116 111 11111 1   
                                    
  1       1             1     1     
  1       1             1     1     
  1       1             1     1     
  1       1             1     1     
  1       1             1     1     
  1       1             1     1     
  1 1111111 1111111 11111     1     
                              1     
  1       1       1     1     1     
  1       1       1     1     1     
  1       1       1 11111 11114     
  1       1                         
  1       1       1           1     
  1       1       1           1     
1 1 1111113 1111111 11111 11111     
                                    
1                 1     1           
1                 1     1           
1                 1     1           
1                 1     1           
1 1111111 11111 111 11111 111111111 
                                    
        1     1                   1 
        1     1                   1 
        1     1                   1 
        1     1                   1 
        1 11111                   1 
                                  1 
        1     1                   1 
        1     1                   1 
1 111 11; 111 1 111 11111 11111 111 
                                    
1   1       1     1     1     1   1 
1   1       1     1     1     1   1 
1   1       1 11111 11111     1   1 
1   1                         1   1 
1   1             1           1   1 
1   1             1           1   1 
1 111             1           1 111 
                  1                 
1   4 1111111 11111 11111 11116   1 
1                                 1 
1   1       1     1     1     1   1 
1   1       1     1     1     1   1 
1   1       1     1     1     1   1 
1   1       1     1     1     1   1 
3 111 1111111 11111 11111 11111 115 
                                    
    1             1           1     
    1             1           1     
    1             1           1     
    1             1           1     
1 111 1 111 1111111 11111 111 1 111 
                                    
1     1   1             1   1     1 
1     1   1             1   1     1 
1     1   1             1   1     1 
1     1   1             1   1     1 
1 111 1   1 1 1111111 111   1 1 111 
                                    
    1       1       1         1     
    1       1       1         1     
    1       1       1         1     
    1       1       1         1     
    1       1       1         1     
    1       1       1         1     
    1 1111111 11  111 111111111     
                                    
                                    
                                    
                                    
                                    
                                    
                                    
                                    
                                    
*