Textures/town2.bmp
13 0
15 83
0
           300002 
        E  1    1 
           400705 
              1   
300070007000009   
1   1   1     1   
1   1   1     1   
1B  1   1     1   
1   1   1 A   1   
407060006007006002
  1        1     1
  1G     G 1     1
  1   E    1 C   1
  4000007076000705
        1 1    1  
    F   1 1 F  1  
  3000006760000602
  1      1       1
  4700070607000705
   1   1   1   1  
   1   1G  1 E 1  
   407060076000602
     1    1      1
300009 F  1   G  1
1    1    1      1
400706070060007005
   1   1      1   
   1   80002  1   
   1   1   1  1 K 
   40006070:009   
         1 1  1   
   E     1 1  8002
      D  1 1  1  1
    30000609  1  1
    1      1  1  1
 3009F G F 1  8005
 1  1      1  1   
 1  1      8009   
 800:0000009  1   
 1  1      1E 1   
 1  1  H   1  1   
 1  8000000:005   
 1  1      1      
 4009G   G 800002 
    1      1    1 
    8007000600705 
    1  1      1   
30009  1      1   
1   1  1B  I  1   
40706076000000:002
  1   1       1  1
  1   1E    E 1  1
  1   1       1  1
  8000607000009  1
  1     1     1  1
  1     1     8005
  1 C   1  L  1   
306007006007006002
1    1     1     1
1 E  1     1  E  1
407076007006000009
  1 1   1        1
  1 1 H 1        1
  80:0006002  J  1
  1 1      1     1
  1 1      1E    1
  40:0000706007005
    1    1    1   
    1 F  1G   1   
 3009    80000602 
 1  1    1      1 
 1  1 K  1      1 
 400:000060700075 
    1      1   1  
    1G  H  1   1  
    4000000:0009  
           1   1  
           1   1  
    J   C  40;05  
             1    
             1    
             1    
             1    
             1    
*
                      1 111111111   
                                    
                      1         1   
                      1         1   
                      1 11111 111   
                                    
                            1       
                            1       
3 1111111 1111111 11111111111       
                                    
1       1       1           1       
1       1       1           1       
1       1       1           1       
1       1       1           1       
1       1       1           1       
1       1       1           1       
1       1       1           1       
1       1       1           1       
1 111 118 1111111 11111 11112 11111 
                                    
    1                 1           1 
    1                 1           1 
    1                 1           1 
    1                 1           1 
    1                 1           1 
    1                 1           1 
    1 11111111111 111 1 1111111 111 
                                    
                1   1         1     
                1   1         1     
                1   1         1     
                1   1         1     
    1 11111111114 1 1 111111111 111 
                                    
    1             1               1 
    1             1               1 
    1 1 1111111 111 111 1111111 113 
                                    
      1       1       1       1     
      1       1       1       1     
      1       1       1       1     
      1       1       1       1     
      1 115 111 11111 1 1111111 111 
                                    
          1         1             1 
          1         1             1 
1 111111111         1             1 
                    1             1 
1         1         1             1 
1         1         1             1 
1 11116 111 111 11111 1111111 11112 
                                    
      1       1             1       
      1       1             1       
      1       1 1111111     1       
      1                     1       
      1       1       1     1       
      1       1       1     1       
      1 1111111 111 111 11111       
                                    
                  1   1     1       
                  1   1     1       
                  1   1     1 11113 
                  1   1             
                  1   1     1     1 
                  1   1     1     1 
        : 111111111 111     1     1 
                            1     1 
        1             1     1     1 
        1             1     1     1 
  1 11111             1     1 11111 
                      1             
  1     1             1     1       
  1     1             1     1       
  1     1             1 11115       
  1     1                           
  6 11111 1111111111111     1       
                            1       
  1     1             1     1       
  1     1             1     1       
  1     1             1     1       
  1     1             1     1       
  1     1 1111111111111 11111       
  1                                 
  1     1             1             
  1     1             1             
  1 11111             ; 111111111   
                                    
        1             1         1   
        1             1         1   
        6 11111 1111111 11111 111   
                                    
        1     1             1       
        1     1             1       
1 1111111     1             1       
              1             1       
1       1     1             1       
1       1     1             1       
1 111 111 111 1 1111111111115 11111 
                                    
    1       1               1     1 
    1       1               1     1 
    1       1               1     1 
    1       1               1     1 
    1       1               1     1 
    1       1               1     1 
    1 1111112 111 11111111111     1 
                                  1 
    1           1           1     1 
    1           1           1     1 
    1           1           1 11111 
    1           1                   
    1           1           1       
    1           1           1       
1 111 11111 11111 11111 11111 11111 
                                    
1         1           1           1 
1         1           1           1 
1         1           1           1 
1         1           1           1 
5 111 111 1 11111 11114 11111111111 
                                    
    1   1       1                 1 
    1   1       1                 1 
    1   1       1                 1 
    1   1       1                 1 
    1 111 1111111 11111           1 
                                  1 
    1   1             1           1 
    1   1             1           1 
    1   1             1           1 
    1   1             1           1 
    1 111 111111111 111 11111 1111; 
                                    
        1         1         1       
        1         1         1       
        1         1         1       
        1         1         1       
  6 11111         1 111111111 111   
                                    
  1     1         1             1   
  1     1         1             1   
  1     1         1             1   
  1     1         1             1   
  3 11111 111111111 111 1111117 1   
                                    
        1             1       1     
        1             1       1     
        1             1       1     
        1             1       1     
        1 1111111111111 1111111     
                                    
                                    
                                    
                                    
                                    
                                    
                                    
                                    
                                    
                                    
                                    
                                    
                                    
                                    
                                    
                                    
                                    
*