Textures/desert1.bmp
0 0
1 101
0
302               
1 8002            
475  1   B        
 1   1            
 1 A 1            
 1   802          
 80705 802        
 1 1   1 1        
 1 1   1 1        
 4067075 1    C   
    1 1  1        
 3005 1  1        
 1    1  1        
 807009  1        
 1 1  80762       
 1 1  1 1 1       
 1 1  1 1 1       
 47600:05 1       
  1   1   1  B    
  1   80705       
30:0709 1         
1 1 1 1 1         
1 1 1 1 1         
409 1 1 1         
  1 1 1 1 C       
  1 1 1 1         
  40:067602     A 
    1  1  1       
    1  1  1       
 C  1  1  1       
    4076709D      
      1 1 802     
      1 1 1 1     
    30675 1 1     
    1  1  1 1     
    407607609     
      1  1  1     
      1  1  1     
      800:075     
  B   1  1 1    C 
      47067602    
       1  1  1    
       4076705    
         1 1      
     30009 80002  
     1   1 1   1  
 C   1 309 802 1  
     1 1 475 1 1  
     1 1  1  1 1  
     1 400:005 1  
     1 300:002 1B 
     1 1  1  1 1  
 A   1 1 362 1 1  
     1 409 805 1  
     1   1 1   1  
     40009 80005  
         1 1      
       3067602    
   B   1  1  1    
      36076705    
      1  1 1   C  
      800:062     
      1  1  1     
C     1  1  1     
    306706709     
    1  1  1 1     
    40762 1 1     
      1 1 1 1  A  
      1 1 805     
    3067609       
    1  1  1       
    1  1  1       
    1  1  1       
  30:076705D      
  1 1 1 1         
  1 1 1 1         
309 1 1 1         
1 1 1 1 1      C  
1 1 1 1 1         
40:0609 1         
  1   80602       
  1   1   1       
 36700:02 1 A     
 1 1  1 1 1       
 1 1  1 1 1       
 1 1  80675       
 806009  1        
 1    1  1   B    
 4002 1  1        
    1 1  1        
 3076062 1        
 1 1   1 1        
 1 1   1 1        
 80602 805      C 
 1   405          
362               
1 1     B         
4;5               
 1                
 1                
 1                
 1                
*
1 111                               
                                    
1   1 11111                         
1                                   
1 1 1     1                         
          1                         
  1       1                         
  1       1                         
  1       1                         
  1       1                         
  1       1 111                     
  1                                 
  1 111 111   1 111                 
                                    
  1   1       1   1                 
  1   1       1   1                 
  1   1       1   1                 
  1   1       1   1                 
  5 111 1 111 1   1                 
                  1                 
        1   1     1                 
        1   1     1                 
  1 11116   1     1                 
            1     1                 
  1         1     1                 
  1         1     1                 
  1 111 11111     1                 
                  1                 
  1   1     1 111 1 1               
  1   1                             
  1   1     1   1   1               
  1   1     1   1   1               
  1   1     1   1   1               
  1   1     1   1   1               
  4 1 1 11111 117   1               
                    1               
    1       1       1               
    1       1       1               
    1       1 111 112               
    1                               
1 111 111 111   1                   
                1                   
1   1   1   1   1                   
1   1   1   1   1                   
1   1   1   1   1                   
1   1   1   1   1                   
5 111   1   1   1                   
        1   1   1                   
    1   1   1   1                   
    1   1   1   1                   
    1   1   1   1                   
    1   1   1   1                   
    1 11> 111 1 1 111               
                                    
        1     1     1               
        1     1     1               
        1     1     1               
        1     1     1               
        1     1     1               
        1     1     1               
        1 111 1 1 111               
                                    
            1   1   1 11<           
            1   1                   
            1   1   1   1           
            1   1   1   1           
        1 111 1 6   1   1           
                    1   1           
        1     1     1   1           
        1     1     1   1           
        1 111 1 111 1 111           
                                    
            1     1     1           
            1     1     1           
            1     1     1           
            1     1     1           
            1 11111 118 1           
                                    
            1     1   1             
            1     1   1             
            1 1 111 1 1 111         
                                    
              1     1     1         
              1     1     1         
              1 111 6 1 111         
                                    
                  1   1             
                  1   1             
          5 1111111   1 111111:     
                                    
          1       1   1       1     
          1       1   1       1     
          1   1 111   1 111   1     
          1                   1     
          1   1   1 4 1   1   1     
          1   1           1   1     
          1   1     1     1   1     
          1   1     1     1   1     
          1   1 11111 11111   1     
          1                   1     
          1   1 11111 11111   1     
          1                   1     
          1   1     1     1   1     
          1   1     1     1   1     
          1   1   1 4 1   1   1     
          1   1           1   1     
          1   1 111   1 111   1     
          1                   1     
          1       1   1       1     
          1       1   1       1     
          : 1111111   1 1111115     
                                    
                  1   1             
                  1   1             
              1 111 6 1 111         
                                    
              1     1     1         
              1     1               
            1 1 111 1 1 111         
                                    
            1     1   1             
            1     1   1             
            1 11111 118 1           
                                    
            1     1     1           
            1           1           
            1     1     1           
            1     1     1           
        1 111 1 111 1 111           
                                    
              1     1   1           
              1     1   1           
        1 111 1 6   1   1           
                    1   1           
            1   1   1   1           
            1   1   1   1           
            1   1   1 11<           
            1   1                   
        1 111 1 1 111               
                                    
        1     1     1               
        1     1     1               
        1     1     1               
        1     1     1               
        1     1     1               
        1     1     1               
    1 11> 111 1 1 115               
                                    
    1   1   1   1                   
    1   1   1   1                   
    1   1   1   1                   
    1   1   1   1                   
5 111   1   1   1                   
        1   1   1                   
1   1   1   1   1                   
1   1   1   1   1                   
1   1   1   1   1                   
1   1   1   1   1                   
1 111 111 111   1                   
                1                   
    1       1 111 112               
    1                               
    1               1               
    1       1       1               
  4 1 1 11111 117   1               
                    1               
      1     1   1   1               
  1   1     1   1   1               
  1   1     1   1   1               
  1   1     1   1   1               
  1   1     1 111 1 1               
  1   1                             
  1 111 11111     1                 
                  1                 
  1         1     1                 
  1         1     1                 
  1 11111   1     1                 
            1     1                 
        1   1     1                 
        1   1     1                 
  5 111 1 111 6   1                 
                  1                 
  1   1       1   1                 
  1   1       1   1                 
  1   1       1   1                 
  1   1       1   1                 
  1 111 111   1 111                 
                                    
  1       1 111                     
  1                                 
1 1 1                               
                                    
1   1                               
1   1                               
1   1                               
                                    
                                    
                                    
                                    
                                    
                                    
                                    
                                    
                                    
*