Textures/town1.bmp
0 1
10 94
0
                  
300000700000000002
1     1          1
1  G  1 E  F   F 1
800000:00000700009
1     1     1    1
1     1     1 E  1
1B    1 L   1    1
800000600000:00009
1           1    1
1 G    G    1    1
1        E  1 H  1
1           1    1
1   D       1    1
800007000700600009
1    1   1       1
1 H  1 F 1G F  G 1
1    1   1       1
80000:000:00000009
1    1   1       1
1 G  1 E 1       1
1    1   1K   J  1
800009 F 800000009
1    1   1       1
1 E  1   1F G  F 1
80000:000600707005
1    1      1 1   
1 F  1G H G 1 1   
1    1      1 1   
80000600000060:002
1             1  1
1    G      F 1  1
1 I     C     1  1
80000000700000:009
1       1     1  1
1   F   1     1  1
400700076000076009
   1   1     1   1
   1   1F  G 1 F 1
   1 E 1     1   1
   4000:00000:0005
       1     1    
       1     1    
    L  1 B   1    
       8000009    
       1     1    
       1  G  1    
     30600700602  
     1    1    1  
     1 F  1 F  1  
   3060000:00075  
   1      1   1   
   1    G 1 E 1   
   1 C    1   1   
   400070067005   
       1   1      
       1 H 1      
    K  1   1E     
3000000:000:000002
1      1   1     1
1G   F 1   1F  G 1
1      1E  1     1
80007006000:000009
1   1      1     1
1   1G   G 1     1
1   1  H   1     1
1B  1      1 I   1
800060700076000009
1     1   1      1
1     1   1G     1
1     1 E 1      1
1 L   1   1  J   1
800000607060700009
1       1   1    1
1       1G  1 G  1
1       1   1    1
1 A     1F  1 H  1
407007006000:00009
  1  1      1    1
  1  1  F   1    1
  1E 1      1D   1
306006070000:00005
1      1    1     
1      1    1F G  
1 C    1 K  1     
8007000:0000600002
1  1   1         1
1F 1   1G      G 1
1  1E  1    H    1
4006000600;0000005
          1       
   F      1F      
       B  1     E 
 E        1       
          1 D     
*
                                    
                                    
1 11111111111 111111111111111111111 
                                    
1           1                     1 
1           1                     1 
1           1                     1 
1           1                     1 
1 11111111111 11111111111 111111111 
                                    
1           1           1         1 
1           1           1         1 
1           1           1         1 
1           1           1         1 
1           1           1         1 
1           1           1         1 
1 11111111111 11111111111 111111113 
                                    
1                       1         1 
1                       1         1 
1                       1         1 
1                       1         1 
1                       1         1 
1                       1         1 
1                       1         1 
1                       1         1 
1                       1         1 
1                       1         1 
1 111111111 1111111 11112 111111111 
                                    
1         1       1               1 
1         1       1               1 
1         1       1               1 
1         1       1               1 
1         1       1               1 
1         1       1               1 
4 111111111 1111111 111111111111111 
                                    
1         1       1               1 
1         1       1               1 
1         1       1               1 
1         1       1               1 
1         1       1               1 
1         1       1               1 
1 111111111       1 111111111111111 
                                    
1         1       1               1 
1         1       1               1 
1         1       1               1 
1         1       1               1 
1 11111111: 1111111 11111 111 11116 
                                    
1         1             1   1       
1         1             1   1       
1         1             1   1       
1         1             1   1       
1         1             1   1       
1         1             1   1       
1 111111111 1111111111111 111 11111 
                                    
1                           1     1 
1                           1     1 
1                           1     1 
1                           1     1 
1                           1     1 
1                           1     1 
5 111111111111111 1111111111B 11111 
                                    
1               1           1     1 
1               1           1     1 
1               1           1     1 
1               1           1     1 
1 11111 1111111 1 111111111 1 11111 
                                    
      1       1           1       1 
      1       1           1       1 
      1       1           1       1 
      1       1           1       1 
      1       1           1       1 
      1       1           1       1 
      1 1111111 11111111118 1111111 
                                    
              1           1         
              1           1         
              1           1         
              1           1         
              1           1         
              1           1         
              6 1111111111:         
                                    
              1           1         
              1           1         
              1           1         
              1           1         
          1 111 11111 11111 111     
                                    
          1         1         1     
          1         1         1     
          1         1         1     
          1         1         1     
      1 111 111111111 1111111 1     
                                    
      1             1       1       
      1             1       1       
      1             1       1       
      1             1       1       
      1             1       1       
      1             1       1       
      5 1111111 11111 1 11111       
                                    
              1       1             
              1       1             
              1       1             
              1       1             
              1       1             
              1       1             
1 1111111111111 1111111 11111111111 
                                    
1             1       1           1 
1             1       1           1 
1             1       1           1 
1             1       1           1 
1             1       1           1 
1             1       1           1 
1 1111111 11113 111111: 11111111111 
                                    
1       1             1           1 
1       1             1           1 
1       1             1           1 
1       1             1           1 
1       1             1           1 
1       1             1           1 
1       1             1           1 
1       1             1           1 
1 1111111 111 1111111 1 11111111111 
                                    
1           1       1             1 
1           1       1             1 
1           1       1             1 
1           1       1             1 
1           1       1             1 
1           1       1             1 
1           1       1             1 
1           1       1             1 
4 11111111111 111 111 112 111111111 
                                    
1               1       1         1 
1               1       1         1 
1               1       1         1 
1               1       1         1 
1               1       1         1 
1               1       1         1 
1               1       1         1 
1               1       1         1 
1 111 11111 11111 1111111 111111111 
                                    
    1     1             1         1 
    1     1             1         1 
    1     1             1         1 
    1     1             1         1 
    1     1             1         1 
    1     1             1         1 
1 111 11117 111 111111111 111111111 
                                    
1             1         1           
1             1         1           
1             1         1           
1             1         1           
1             1         1           
1             1         1           
1 11111 1111111 111111111 111111111 
                                    
1     1       1                   1 
                                  1 
1     1       1                   1 
1     1       1                   1 
1     1       1                   1 
1     1       1                   1 
1 11111 1111111 1111  1111111111113 
                                    
                                    
                                    
                                    
                                    
                                    
                                    
                                    
                                    
                                    
                                    
*