Textures/classic6.bmp
8 0
8 84
0
      3000002     
      1     1     
      1     1     
    306007075     
    1    1 1      
    1    1 1      
3000:007060:002   
1   1  1   1  1   
1   1  1   1  1   
8007600:0006705   
1  1   1    1     
1  1   1    1     
800:0009  3062    
1  1   1  1  1    
8006000:009  1    
1      1  8005    
1      1  1       
40700709  1       
  1  1 4709       
  1  1  1 1       
  8009  809       
  1  1  1 1       
  1  1  1 1       
  800:00:060007002
  1  1  1     1  1
  1  1  1     1  1
  470600:00700:009
   1    1  1  1  1
   1    800:006009
   1    1  1     1
   470009  8007005
    1   1  1  1   
    1   1  8009   
    47009  1  1   
     1  8006705   
     1  1   1     
     1  1   1     
  30760760009     
  1 1  1    8002  
  805  1    1  1  
  1    1    1  1  
  80070600706009  
  1  1    1    1  
  1  1    1    1  
  1  1    1    1  
  400:0070607005  
     1  1   1     
     1  1   1     
     47067009     
      1  1  1     
      1  8009     
    309  1  1     
    1 4075 362    
    1   1  1 1    
    1   1  1 1    
    8000:07609    
    1   1 1  1    
    1 30:05  8002 
    1 1 1    1  1 
    8060:0070:009 
    1   1  1 1  1 
    1   1  1 1  1 
    80006009 8009 
    1      1 1  1 
  309      809  1 
  1 1      1 8005 
 360:007007609    
 1  1  1  1  1    
 1  8009  1  1    
 8009  800:009    
 1  1  1  1  1    
 400670:076005    
     1 1 1        
     1 1 1        
 3070:0:060700702 
 1 1 1 1   1  1 1 
 8060606000670609 
 1          1   1 
 4000000;00060005 
        1         
        1         
        1         
        1         
        1         
        1         
*
            1 11111111111           
                                    
            1           1           
            1           1           
            1           1           
            1           1           
        1 111 11111 111 1           
                                    
        1         1   1             
        1         1   1             
        1         1   1             
        1         1   1             
1 1111111 11111 121 111 11111       
                                    
1       1     1       1     3       
1       1     1       1     1       
1       1     1       1     B       
1       1     1       1     1       
4 11111 1 11111 1111111 1 111       
                                    
1     1       1         1           
1     1       1         1           
1     1       1         1           
1     1       1         1           
1 11111 1111111     1 111 1         
                                    
1     1       1     1     1         
1     1       1     1     1         
1 11111 1111111 11113     1         
                          1         
1             1     1 11111         
1             1                     
1             1     1               
1             1     1               
1 11= 11111 111     1               
                    1               
    1     1   1 1 111               
    1     1                         
    1     1     1   1               
    1     1     1   1               
    1 11111     1 111               
                                    
    1     1     1   1               
    1     1     1   1               
    1     1     1   1               
    1     1     1   1               
    1 11111 11111 111 1111111 11111 
                                    
    1     1     1           1     1 
    1     1     1           1     1 
    1     1     1           1     1 
    1     1     1           1     1 
    1 1 111 11111 11111 11111 11113 
                                    
      1         1     1     1     1 
      1         1     1     1     1 
      1         1 11111 11111 11111 
      2                             
      1         1     1           1 
      1         1     1           1 
      1 1 1111117     1 11111 11111 
                                    
        1       1     1     1       
        1       1     1     1       
        1       1     1 11111       
        1       1                   
        1 1 11111     1     1       
                      1     1       
          1     1 11111 1 111       
          1                         
          1     1       1           
          1     1       1           
          1     1       1           
          1     1       1           
    1 111 1 111 1 1111111           
                                    
    1   1     1         1 11111     
    1   1     1                     
    1 111     1         1     1     
              1         1     1     
    1         1         1     1     
    1         1         1     1     
    : 11111 111 11116 111 11111     
                                    
    1     1         1         1     
    1     1         1         1     
    1     1         1         1     
    1     1         1         1     
    1     1         1         1     
    1     1         1         1     
    1 11111 11111 111 111 11111     
                                    
          1     1       1           
          1     1       1           
          1     1       1           
          1     1       1           
          1 1 111 1 11111           
                                    
            1     1     1           
            1     1     1           
            1     1 11111           
            1                       
        2 111     1     1           
                  1     1           
        1   1 111 1   B 1 1         
        1                           
        1       1     1   1         
        1       1     1   1         
        1       1     1   1         
        1       1     1   1         
        1 1111111 111 1 111         
                                    
        1       1   1     1         
        1       1   1     1         
        1   1 111 111     1 11111   
        1                           
        1   1   1         1     1   
        1   1   1         1     1   
        1 111 111 11111 111 11111   
                                    
        1       1     1   1     1   
        1       1     1   1     1   
        1       1     1   1     1   
        1       1     1   1     1   
        1 1111111 11111   1 11111   
                                    
        1             1   1     1   
        1             1   1     8   
    1 111             1 111     1   
                                1   
    1   1             1   1 11111   
    1   1             1             
  1 1 111 1111: 11111 1 111         
                                    
  1     1     1     1     1         
  1     1     1     1     1         
  1     1 11111     1     1         
  1                 1     1         
  1 11111     1 11111 11111         
                                    
  1     1     1     1     1         
  1     1     1     1     1         
  1 11111 1 111 111 1 11111         
                                    
          1   1   1                 
          1   1   1                 
          1   1   1                 
          1   1   1                 
  1 111 111 111 111 111 11111 111   
                                    
  1   1   1   1       1     1   1   
  1   1   1   1       1     1   1   
  1 111 111 111 1171111 1 111 111   
                                    
  1                     1       1   
  1                     1       1   
  1 111111111111  1111111 1111111   
                                    
                                    
                                    
                                    
                                    
                                    
                                    
                                    
                                    
                                    
                                    
                                    
                                    
*