
 8000:0007000:0009
 1   1   1   1   1
 1F  1   1   1 F 1
 1   1   1   1   1
 80706070607060709
 1 1   1   1   1 1
 1 1   1   1   1 1
 1 1B  1   1K  1 1
 806000:0006070609
 1     1     1   1
 1     1F  G 1   1
 1 J   1     1E  1
 800000:00000:0009
 1     1     1   1
 1 F   1  E  1   1
 800000600000:0009
 1           1   1
 1G    H   G 1 F 1
 80000070000060009
 1     1         1
 1 E   1     E   1
 80000060000000009
 1               1
 4002G      G 3005
    1   D     1   
  F 1         1F  
    80700000709   
    1 1     1 1   
    1 1     1 1   
 300:09     80:002
 1  1 1     1 1  1
 1  1 1 A   1 1  1
 1E 1 1     1 1E 1
 40060602 30606005
        1 1       
 F    G 1 1G    F 
 3000000:0:0000002
 1      1 1      1
 1      1 1      1
 1      1 1      1
 1 A    1 1 A    1
 80007006760070009
 1   1   1   1   1
 1 F 1 G 1 G 1 F 1
 1   1   1   1   1
 1   1   1   1   1
 80006007670060009
 1      1 1      1
 1    E 1 1      1
 1 B    1 1E K   1
 80070005 40007009
 1  1         1  1
 1  1         1  1
 1  1   H     1  1
 800:000070000:009
 1  1    1    1  1
 1E 1 F  1 F  1E 1
 400:0000:0000:005
    1    1    1   
    1 G  1 G  1   
 300:000060000:002
 1  1         1  1
 1E 1    H    1E 1
 400:000000000:005
    1         1   
    1         1   
    1 C    L  1   
 300:000000000:002
 1  1         1  1
 1E 1G  F   G 1E 1
 400:000070000:005
    1    1    1   
    1    1    1   
    1    1    1   
    1A   1A   1   
 300:000060000:002
 1  1         1  1
 1E 1F   G  F 1E 1
 80060000000006009
 1               1
 1               1
 1L  E  J   E B  1
 40000002 30000005
        1 1       
 F    G 809G    F 
        1 1       
 30000005 40000002
 1               1
 1               1
 1               1
 1 L    I     C  1
 80007000700070009
 1   1   1   1   1
 1E  1 F 1F  1 E 1
 1   1   1   1   1
 8000:0006000:0009
 1   1       1   1
 1   1       1   1
 1K  1  D    1B  1
 80006070007060009
 1     1   1     1
 1 F   1G  1  F  1
 1     1   1     1
 400000:000:000005
*
  1 1111111 1111111 1111111 1111111 
                                    
  1       1       1       1       1 
  1       1       1       1       1 
  1       1       1       1       1 
  1       1       1       1       1 
  1       1       1       1       1 
  1       1       1       1       1 
  1 111 111 111 11B 111 111 111 111 
                                    
  1   1       1       1       1   1 
  1   1       1       1       1   1 
  1   1       1       1       1   1 
  1   6       1       1       6   1 
  1   1       1       1       1   1 
  1   1       1       1       1   1 
  1 111 1111111 1111111 111 111 111 
                                    
  1           1           1       1 
  1           1           1       1 
  1           1           1       1 
  1           1           1       1 
  1           1           1       1 
  1           1           1       1 
  2 11111111111 11111111111 1111112 
                                    
  1           1           1       1 
  1           1           1       1 
  1           1           1       1 
  1           1           1       1 
  1 11111111111 11111111111 1111111 
                                    
  1                       1       1 
  1                       1       1 
  1                       1       1 
  1                       1       1 
  7 11111111111 11111111111 1111118 
                                    
  1           1                   1 
  1           1                   1 
  1           1                   1 
  1           1                   1 
  1 11111111111 111 111111111111111 
                                    
  1                               1 
  1                               1 
  > 11111                   1 1111> 
                                    
        1                   1       
        1                   1       
        1                   1       
        1                   1       
        1 111 11113111111 111       
                                    
        1   1           1   1       
        1   1           1   1       
        1   1           1   1       
        1   1           1   1       
  2 11111 111           1 111 11112 
                                    
  1     1   1           1   1     1 
  1     1   1           1   1     1 
  1     1   1           1   1     1 
  1     1   1           1   1     1 
  1     1   1           1   1     1 
  1     1   1           1   1     1 
  1 11111 111 111   1 111 111 11111 
                                    
                1   1               
                1   1               
                1   1               
                1   1               
  4 1111111111111 111 1111111111114 
                                    
  1             1   1             1 
  1             1   1             1 
  1             1   1             1 
  1             1   1             1 
  1             1   1             1 
  1             1   1             1 
  1             1   1             1 
  1             1   1             1 
  1 1111111 11111 1 1 11111 1111111 
                                    
  1       1       1       1       1 
  1       1       1       1       1 
  1       1       1       1       1 
  1       1       1       1       1 
  1       8       1       7       1 
  1       1       1       1       1 
  1       1       1       1       1 
  1       1       1       1       1 
  1 1111111 11111 1 1 11111 1111111 
                                    
  1             1   1             1 
  1             1   1             1 
  1             1   1             1 
  1             1   1             1 
  1             1   1             1 
  1             1   1             1 
  1 11111 1111112   2 1111111 11111 
                                    
  1     1                   1     1 
  1     1                   1     1 
  1     1                   1     1 
  1     1                   1     1 
  1     1                   1     1 
  1     1                   1     1 
  1 11111 111111111 111111111 11111 
                                    
  1     1         1         1     1 
  1     1         1         1     1 
  1     1         1         1     1 
  1     1         1         1     1 
  1 11111 11111111B 111111111 11111 
                                    
        1         1         1       
        1         1         1       
        1         1         1       
        1         1         1       
  1 11111 111111111 111111111 11111 
                                    
  1     1                   1     1 
  1     1                   1     1 
  1     1                   1     1 
  1     1                   1     1 
  1 11111 11111111:1111111111 11111 
                                    
        1                   1       
        1                   1       
        1                   1       
        1                   1       
        1                   1       
        1                   1       
  1 11111 1111111111111111111 11111 
                                    
  1     1                   1     1 
  5     1                   1     5 
  1     1                   1     1 
  1     1                   1     1 
  1 11111 111111111 111111111 11111 
                                    
        1         1         1       
        1         1         1       
        1         1         1       
        1         1         1       
        1         1         1       
        1         1         1       
        1         1         1       
        1         1         1       
  1 11112 111111111 111111112 11111 
                                    
  1     1                   1     1 
  1     1                   1     1 
  1     1                   1     1 
  1     1                   1     1 
  1 11111 1111111111111111111 11111 
                                    
  1                               1 
  1                               1 
  1                               1 
  1                               1 
  1                               1 
  1                               1 
  1 1111111111111   1 1111111111111 
                                    
                1   1               
                1   1               
                1 B11               
                                    
                1   1               
                1   1               
  3 1111111111111   1 1111111111113 
                                    
  1                               1 
  1                               1 
  1                               1 
  1                               1 
  1                               1 
  1                               1 
  1                               1 
  1                               1 
  1 1111111 1111111 1111111 1111111 
                                    
  1       1       1       1       1 
  1       1       1       1       1 
  1       1       1       1       1 
  1       1       1       1       1 
  1       1       1       1       1 
  1       1       1       1       1 
  1 1111111 111111: 1111111 1111111 
                                    
  1       1               1       1 
  1       1               1       1 
  1       1               1       1 
  1       1               1       1 
  1       1               1       1 
  1       1               1       1 
  1 1111111 111 1181111 111 1111111 
                                    
  1           1       1           1 
  1           1       1           1 
  1           1       1           1 
  1           1       1           1 
  1           1       1           1 
  1           1       1           1 
  6 11111111111 1111111 11111111116 