Textures/town2.bmp
13 0
15 83
0
            30002 
        E   1   1 
            40705 
              1   
              1   
300070007000009   
1   1   1     1   
1B  1   1     1   
1   1   1 I   1   
4000:000600700602 
    1      1    1 
    1G   G 1    1 
    1  E   1 C  1 
    4000707600075 
        1 1    1  
    F   1 1 F  1  
  3007006760000602
  1  1   1       1
  4706070607000705
   1   1   1   1  
   1   1G  1 E 1  
   407060076000602
     1    1      1
 30009 F  1   G  1
 1   1    1      1
 40706070060007005
   1   1      1   
   1   80002  1   
   1   1   1  1K  
   40006070:009   
         1 1  1   
   E     1 1  8002
      D  1 1  1  1
    30000609  1  1
    1      1  1  1
 3009F G F 1  8005
 1  1      1  1   
 1  1      8009   
 800:0700709  1   
 1  1 1  1 1E 1   
 1  1 1H 1 1  1   
 1  8060060:005   
 4009      1      
    1G   G 800702 
    1      1  1 1 
    8007000600:05 
    1  1      1   
30009  1      1   
1   1  1B  I  1   
40706076007000:002
  1   1   1   1  1
  1   1E  1 E 1  1
  1   1   1   8009
  8000607060009  1
  1     1     1  1
  1     1     8005
  1 C   1  L  1   
306007006007006002
1    1     1     1
1 E  1     1  E  1
407076007006000009
  1 1   1        1
  1 1 H 1        1
  80:0006002  J  1
  1 1      1  3009
  1 1      1E 1  1
  40:000070600:005
    1    1    1   
    1 F  1G   1   
 3009    80000602 
 1  1    1      1 
 1  1 K  1      1 
 400:000060700075 
    1      1   1  
    1G  H  1   1  
    4000000:0009  
           1   1  
           1   1  
    J   C  40;05  
             1    
             1    
             1    
             1    
             1    
*
                        1 1111111   
                                    
                        1       1   
                        1       1   
                        1 111 111   
                                    
                            1       
                            1       
                            1       
                            1       
3 1111111 1111111 11111111111       
                                    
1       1       1           1       
1       1       1           1       
1       1       1           1       
1       1       1           1       
1       1       1           1       
1       1       1           1       
1 1111118 1111111 11111 11112 111   
                                    
        1             1         1   
        1             1         1   
        1             1         1   
        1             1         1   
        1             1         1   
        1             1         1   
        1 1111111 111 1 1111111 1   
                                    
                1   1         1     
                1   1         1     
                1   1         1     
                1   1         1     
    1 11111 11114 1 1 111111111 111 
                                    
    1     1       1               1 
    1     1       1               1 
    1 1 111 111 111 111 1111111 113 
                                    
      1       1       1       1     
      1       1       1       1     
      1       1       1       1     
      1       1       1       1     
      1 115 111 11111 1 1111111 111 
                                    
          1         1             1 
          1         1             1 
  1 1111111         1             1 
                    1             1 
  1       1         1             1 
  1       1         1             1 
  1 116 111 111 11111 1111111 11112 
                                    
      1       1             1       
      1       1             1       
      1       1 1111111     1       
      1                     1       
      1       1       1     1       
      1       1       1     1       
      1 1111111 111 111 11111       
                                    
                  1   1     1       
                  1   1     1       
                  1   1     1 11113 
                  1   1             
                  1   1     1     1 
                  1   1     1     1 
        : 111111111 111     1     1 
                            1     1 
        1             1     1     1 
        1             1     1     1 
  1 11111             1     1 11111 
                      1             
  1     1             1     1       
  1     1             1     1       
  1     1             1 11115       
  1     1                           
  6 11111 111 11111 111     1       
                            1       
  1     1   1     1   1     1       
  1     1   1     1   1     1       
  1     1   1     1   1     1       
  1     1   1     1   1     1       
  1     1 111 11111 111 11111       
  1                                 
  1 11111             1             
                      1             
        1             ; 11111 111   
        1                           
        1             1     1   1   
        1             1     1   1   
        6 11111 1111111 11111 111   
                                    
        1     1             1       
        1     1             1       
1 1111111     1             1       
              1             1       
1       1     1             1       
1       1     1             1       
1 111 111 111 1 11111 1111115 11111 
                                    
    1       1       1       1     1 
    1       1       1       1     1 
    1       1       1       1     1 
    1       1       1       1     1 
    1       1       1       1 11111 
    1       1       1               
    1 1111112 111 111 1111111     1 
                                  1 
    1           1           1     1 
    1           1           1     1 
    1           1           1 11111 
    1           1                   
    1           1           1       
    1           1           1       
1 111 11111 11111 11111 11111 11111 
                                    
1         1           1           1 
1         1           1           1 
1         1           1           1 
1         1           1           1 
5 111 111 1 11111 11114 11111111111 
                                    
    1   1       1                 1 
    1   1       1                 1 
    1   1       1                 1 
    1   1       1                 1 
    1 111 1111111 11111           1 
                                  1 
    1   1             1     1 11111 
    1   1             1             
    1   1             1     1     1 
    1   1             1     1     1 
    1 111 111111111 111 11111 1111; 
                                    
        1         1         1       
        1         1         1       
        1         1         1       
        1         1         1       
  6 11111         1 111111111 111   
                                    
  1     1         1             1   
  1     1         1             1   
  1     1         1             1   
  1     1         1             1   
  3 11111 111111111 111 1111117 1   
                                    
        1             1       1     
        1             1       1     
        1             1       1     
        1             1       1     
        1 1111111111111 1111111     
                                    
                                    
                                    
                                    
                                    
                                    
                                    
                                    
                                    
                                    
                                    
                                    
                                    
                                    
                                    
                                    
                                    
*