Textures/classic7.bmp
5 0
5 118
0
    302           
    1 1           
    475           
     1            
     1            
  300600070002    
  1      1   8002 
309      1   1  1 
1 1      80009  1 
8067007009   8009 
1  1  1  1   1  1 
1  1  1  1   1  1 
80060067060076005 
1      1    1     
8007000:00009     
1  1   1    1     
1  1   1    1     
800:00060700602   
1  1     1    1   
1  1     1    1   
800:00700607009   
1  1  1    1  1   
1  1  1    1  1   
400:00:00006009   
   1  1       1   
   1  1       1   
   400670007009   
       1   1  1   
       1   1  1   
       1   1  1   
       8070:009   
       1 1 1  1   
       1 1 1  1   
       1 1 1  1   
       8060:009   
       1   1  1   
       470767062  
        1 1 1  1  
        1 1 1  1  
        809 8009  
        1 1 1  1  
        1 1 1  1  
        80:06709  
        1 1  1 1  
        1 1  1 1  
        4060760:02
            1  1 1
            1  1 1
          30:07675
          1 1 1 1 
          1 1 1 1 
          809 1 1 
          1 47675 
          1  1 1  
          1  1 1  
          8009 1  
          1  809  
          1  1 1  
          8009 1  
          1  1 1  
307007007067060:02
1 1  1  1  1   1 1
1 80060060060009 1
1 1            1 1
809            809
1 1            1 1
1 40700070007005 1
1   1   1   1    1
400060006070600705
          1    1  
          8002 1  
          1  1 1  
          1  809  
          8009 1  
          1  1 1  
          1 36762 
          1 1 1 1 
          809 809 
          1 809 1 
          1 1 1 1 
          40:06762
            1  1 1
            1  1 1
        30706709 1
        1 1  1 805
        1 1  1 1  
        1 807609  
        1 1 1  1  
        1 1 1  1  
       360676005  
       1   1      
       8070:002   
       1 1 1  1   
       1 1 1  1   
       1 1 1  1   
       8060:006702
       1   1   1 1
       1   1   809
       1   1   1 1
  30700:0706700605
  1 1  1 1  1     
  1 1  1 1  1     
  80600:06009     
  1    1    1     
  800009    1     
  1    1    1     
306000060700670002
1        1   1   1
1        1   1   1
1        1   80009
1        1   1   1
1        1   1   1
1        1   1   1
40000;000600060005
     1            
     1            
     1            
     1            
     1            
*
        1 111                       
                                    
        1   1                       
        1   1                       
        1 1 1                       
                                    
          1                         
          1                         
          1                         
          1                         
    1 1111> 1111111 1111111         
                                    
    1             1       1 11111   
    1             1                 
1 111             1       1     1   
                  1       1     1   
1   1             1 1111111     1   
1   1                           1   
1 111 1 11111 11111       1 11111   
                                    
1     1     1     1       1     1   
1     1     1     1       1     1   
1     1     1     1       1     1   
1     1     1     1       1     1   
1 11111 11111 1 114 11111 1 11111   
                                    
1             1         1           
1             1         1           
1 11111 1111111 111111111           
                                    
1     1       1         1           
1     1       1         1           
1     1       1         1           
1     1       1         1           
1 11111 1111111 111 11111 111       
                                    
1                 1         1       
1                 1         1       
1                 1         1       
1                 1         1       
1 11113 11111 11111 111 11111       
                                    
1     1     1         1     1       
1     1     1         1     1       
1     1     1         1     1       
1     1     1         1     1       
1 11111 11111 111111111 11111       
                                    
      1     1               1       
      1     1               1       
      1     1               1       
      1     1               1       
      1 11111 1 1111117 11111       
                                    
              1       1     1       
              1       1     1       
              1       1     1       
              1       1     1       
              1       1     1       
              1       1     1       
              1 111 111 11115       
                                    
              1   1   1     1       
              1   1   1     1       
              1   1   1     1       
              1   1   1     1       
              1   1   1     1       
              1   1   1     1       
              1 111 111 11111       
                                    
              1       1     1       
              1       1     1       
              1 1 111 : 1 111 1     
                                    
                1   1   1     1     
                1   1   1     1     
                1   1   1     1     
                1   1   1     1     
                1 111   1 11111     
                                    
                1       1     1     
                1   1   1           
                1   1         1     
                1   1   1     1     
                1 111 111 1 111     
                                    
                1   1     1         
                1   1     1   1     
                1         1   1     
                1   1     1   1     
                1 111 111 1 111 111 
                                    
                        1     1   1 
                        1     1   1 
                        1     1   1 
                        1     1   1 
                    1 1 2 111 1 1 1 
                                    
                    1   1   1   1   
                    1       1   1   
                    1   1   1   1   
                    1   1   1   1   
                    1 111   1   1   
                            1   1   
                    1   1 1 1 1 1   
                    1               
                    1     1   1     
                    1     1   1     
                    1     1         
                    1     1   1     
                    1 11111   1     
                              1     
                    1     1 111     
                    1               
                    1     1   1     
                    1     1   1     
                    6 11111   1     
                              1     
                    1     1   1     
                    1     1   1     
1 111 11111 11 11  11 1 111 111 111 
                                    
1   1     1     1     1       1   1 
1   1     1     1     1       1     
1   5 11111 11111 11111 1111111   1 
1                                 1 
1   1                         1   1 
1   1                         1   1 
2 111                         1 1 1 
                                    
1   1                         1   1 
1                             1   1 
1   1 1 1 1111111 1111 11 1 114   1 
1                                 1 
1       1       1       1         1 
1       1       1       1         1 
1 1111111 1111111 111 111 11111 111 
                                    
                    1         1     
                    1         1     
                    1 11111         
                              1     
                    1     1   1     
                    1     1   1     
                    1     1 111     
                    1               
                    6 11111   1     
                              1     
                    1     1   1     
                    1     1   1     
                    1   1 1 1 1 1   
                    1               
                    1   1   1   1   
                    1   1   1   1   
                    1 1 1   1 111   
                                    
                    1   1 111   1   
                    1               
                    1   1   1   1   
                    1   1   1   1   
                    1 112 111 1 1 1 
                                    
                        1     1   1 
                        1         1 
                        1     1   1 
                        1     1   1 
                1 111 111 1 111   1 
                                  1 
                1         1   1 111 
                1   1     1         
                1   1     1   1     
                1   1     1   1     
                1   1 111 1 111     
                1                   
                1   1   1     1     
                1       1     1     
                1   1   1     1     
                1   1   1     1     
              1 1 111 1 1 11111     
                                    
              1       1             
              1       1             
              1 111 11: 1 111       
                                    
              1   1   1     1       
              1   1   1     1       
              1   1   1     1       
              1   1   1     1       
              1   1   1     1       
              1   1   1     1       
              1 115 111 11111 1 111 
                                    
              1       1       1   1 
              1       1       1   1 
              1       1       1 111 
              1       1             
              1       1       1   1 
              1       1       1   1 
    1 111 11111 111 117 1 11111 111 
                                    
    1   1     1   1     1           
    1   1     1   1     1           
    1   1     1   1     1           
    1   1         1     1           
    1 111 11111 111 11111           
                                    
    1         1         1           
    1                   1           
    1 111111111         1           
                        1           
    1         1         1           
    1         1         1           
1 111 111111111 114 11111 1 1111111 
                                    
1                 1       1       1 
1                 1       1       1 
1                 1       1       1 
1                 1       1       1 
1                 1       1 1111111 
1                 1                 
1                 1       1       1 
1                 1       1       1 
1                 1       1       1 
1                 1       1       1 
1                 1       1       1 
1                 1       1       1 
1 11111111  1111111 1111111 1111111 
                                    
                                    
                                    
                                    
                                    
                                    
                                    
                                    
                                    
                                    
                                    
*