Textures/desert1.bmp
8 0
8 115
0
       302        
       1 1        
       475        
        1         
     3006002      
 30009     80002  
 1   1     1   1  
 1   1     1 C 1  
 80009 D   80009  
 1   1     1   1  
 1 B 4700075   1  
 1    1   1    1  
 407006070600705  
   1    1    1    
   1 C  1 B  1    
   40700:00705    
     1  1  1      
     1  1  1      
     1  1  1      
   30607670602    
   1   1 1   1    
   1 A 1 80009    
300:0009 1   8002 
1  1   1 1   1  1 
1  13009 80021  1 
80751  1 1  14709 
1 1 407676705 1 1 
1 1   1 1 1   1 1 
4060705 1 4070605 
    1   1   1     
  C 1 30:02 1     
    1 1 1 1 1     
  30:060:060:02   
  1 1   1   1 1   
  1 1 30:02 1 1   
  409 1 1 1 805   
    1 40:05 1     
    1   1   1  B  
    4070:0705     
 C    1 1 1       
      1 1 1       
30070760:06707002 
1  1 1  1  1 1  1 
1  475  1  475A 1 
1B  1   1   1   1 
40706700:00760705 
  1  1  1  1  1   
 362 1  1  1 362B 
 1 1 1  1  1 1 1  
36067600:00676062 
1   1   1   1   1 
1   1   1   1   1 
80006000:00060009 
1       1       1 
1       1       1 
1       1       1 
80007000:00070009 
1   1   1   1   1 
1   1   1   1 C 1 
1B  8000:0009   1 
80009   1   80009 
1   1   1   1   1 
1   807060709   1 
40705 1   1 40705 
  1   1   1   1   
  1 306070602 1   
  809   1   809   
  1 1   1   1 1   
  8060706070609   
  1   1   1   1   
  40709 A 80705   
    1 80009 1     
    1 1   1 1     
   3609   8062    
   1  1 B 1  1    
   8005   4009    
   1         1    
   8002   3009    
   1  1C  1  1    
   1  80009  1    
   4709   8075 C  
B   1 1   1 1     
    806070609     
    1   1   1     
  309   1   802   
  1 8000:0009 1   
309 1   1   1 802 
1 1 4070:0705 1 1 
1 1   1 1 1   1 1 
1 1   1 1 1 B 1 1 
40607060:06070605 
    1   1   1     
    8000:0009     
    1   1   1     
    1 A 1   1     
    8000:0009     
  C 1   1   1     
    1 30:02 1     
 300:09 1 80:002  
 1  1 40:05 1  1  
 8009   1   8009  
 1  1A  1   1  1  
 1  1   1 B 1  1  
 1  8000:0009  1  
 8009   1   8009  
 1  8000:0009  1  
 1  1   1   1  1  
 8006000:0006009  
 1      1      1  
 1 30000600002 1  
 1 1         1 1  
 4060000;0000605  
        1         
        1         
        1         
    D   1D        
*
              1 111                 
                                    
              1   1                 
              1   1                 
              1 1 1                 
                                    
                1                   
                1                   
          1 11111 11111             
                                    
  1 1111111           1 1111111     
                                    
  1       1           1       1     
  1       1           1       1     
  1       1           1       1     
  1       1           1       1     
  1 1111111           1 1111111     
                                    
  1       1           1       1     
  1       1           1       1     
  1       4 1 1111111 4       1     
  1                           1     
  1         1       1         1     
  1         1       1         1     
  2 111 11111 111 111 11111 112     
                                    
      1         1         1         
      1         1         1         
      1         1         1         
      1         1         1         
      1 115 11111 11115 111         
                                    
          1     1     1             
          1     1     1             
          1     1     1             
          1     1     1             
          1     1     1             
          1     1     1             
      1 111 111 > 1 111 111         
                                    
      1       1   1       1         
      1       1   1       1         
      1       1   1 1111111         
      1       1                     
5 11111 1111111   1       1 11115   
                  1                 
1     1       1   1       1     1   
1     1       1   1       1     1   
1     1 4 11111   1 11114 1     1   
1     1                   1     1   
1 111 : 1     1   1     1 : 1 111   
        1     1   1     1           
1   1   1 111 1 ; 1 1 111   1   1   
1   1                       1   1   
1   1       1   1   1       1   1   
1   1       1   1   1       1   1   
6 111 111 111   1   1 111 111 116   
                1                   
        1       1       1           
        1       1       1           
        1   1 111 111   1           
        1               1           
        1   1   1   1   1           
        1   1   1   1   1           
    1 111 111 111 111 111 111       
                                    
    1   1       1       1   1       
    1   1       1       1   1       
    1   1   4 117 115   1   1       
    1   1               1   1       
    1 111   1   1   1   1 111       
            1   1   1               
        1   5 111 114   1           
        1               1           
        1       1       1           
        1       1       1           
        1 111 111 111 111           
                                    
            1   1   1               
            1   1   1               
            1   1   1               
            1   1   1               
= 11111 111 1 111 111 1 111 1111;   
                                    
1     1   1     1     1   1     1   
1     1   1     1     1   1     1   
1     1 6 1     1     1 6 1     1   
1               1               1   
1       1       1       1       1   
1       1       1       1       1   
1 111 111 1 11111 11111 1 111 111   
                                    
    1     1     1     1     1       
    1     1     1     1     1       
  8 1 5   1     1     1   5 1 7     
          1     1     1             
  1   1   1     1     1   1   1     
  1   1   1     1     1   1   1     
1 1 111 1 1 11111 11111 1 1 111 1   
                                    
1       1       1       1       1   
1       1       1       1       1   
1       1       1       1       1   
1       1       1       1       1   
1 1111111 1111111 1111111 1111111   
                                    
2               3               2   
1               1               1   
1               1               1   
1               1               1   
1               1               1   
1               1               1   
1 1111114 1111111 1111114 1111111   
                                    
1       1       1       1       1   
1       1       1       1       1   
1       1       1       1       1   
1       1       1       1       1   
1       1 1111111 1111111       1   
1                               1   
1 1111111       1       1 1111111   
                1                   
1       1       1       1       1   
1       1       1       1       1   
1       1 111 117 111 111       1   
1                               1   
1 11; 111   1       1   1 11; 111   
            1       1               
    1       1       1       1       
    1       1       1       1       
    1   5 111 111 111 115   1       
    1                       1       
    1 111       1       1 111       
                1                   
    1   1       1       1   1       
    1   1       1       1   1       
    6 111 111 111 111 111 116       
                                    
    1       1       1       1       
    1       1       1       1       
    1 118 111       1 118 111       
                                    
        1   1 1111111   1           
        1               1           
        1   1       1   1           
        1   1       1   1           
      1 1 111       1 111 1         
                                    
      1     1       1     1         
      1     1       1     1         
      1 1111:       : 11111         
                                    
      1                   1         
      1                   1         
      1 11111       1 11111         
                                    
      1     1       1     1         
      1     1       1     1         
      1     1 1111111     1         
      1                   1         
      1 1 111       1 111 1         
                                    
        1   1       1   1           
        1   1       1   1           
        1 111 11; 111 111           
                                    
        1       1       1           
        1       1       1           
    1 111       1       1 111       
                1                   
    1   1 1111111 1111111   1       
    1                       1       
6 111   1       1       1   1 116   
        1       1       1           
1   1   1 115 111 115 111   1   1   
1   1                       1   1   
1   1       1   1   1       1   1   
1   1       1   1   1       1   1   
1   1       1   1   1       1   1   
1   1       1   1   1       1   1   
2 111 111 111 111 111 111 111 112   
                                    
        1       1       1           
        1       1       1           
        7 1111111 1111118           
                                    
        1       1       1           
        1       1       1           
        1       1       1           
        1       1       1           
        1 111111> 1111111           
                                    
        1       1       1           
        1       1       1           
        1   4 111 111   1           
        1               1           
  6 11111 111   1   1 111 11116     
                1                   
  1     1   1 111 116   1     1     
  1     1               1     1     
  1 11111       1       1 11111     
                1                   
  1     1       1       1     1     
  1     1       1       1     1     
  1     1       1       1     1     
  1     1       1       1     1     
  5     1 1111111 1111111     5     
  1                           1     
  1 11111       1       1 11111     
                1                   
  1     1 1111111 1111111     1     
  1                           1     
  1     1       1       1     1     
  1     1       1       1     1     
  4 11111 1111111 1111111 11114     
                                    
  1             1             1     
  1             1             1     
  1   1 111111111 111111111   1     
  1                           1     
  1   1                   1   1     
  1   1                   1   1     
  1 111 11111111  111111111 111     
                                    
                                    
                                    
                                    
                                    
                                    
                                    
                                    
                                    
*