Textures/desert2.bmp
9 0
10 116
0
 30700000000000702
 1 1           1 1
 1 4002     3005 1
 1    1     1    1
 4002 1D    1 3005
    40607070605   
        1 1       
    30005 40002   
    1         1   
 3009 B     C 8002
 1  1  30702  1  1
 1  4005 1 4005  1
 1       1       1
 1       1    A  1
 400002  800700005
      1  1  1     
 300009C 1  800002
 1    1  1B 1    1
 1  306009  402  1
 1  1    1    1  1
 800602  1  306009
 1    1  1  1    1
 1 A  1  1  802  1
 1    1  1C 1 1  1
 4002 1  1  1 4005
    406706075     
       1   1      
   30005   40002  
   1           1  
   1C       B  1  
30062        30602
1   1  D     1   1
1   1        1   1
80076002  30067009
1  1   1  1   1  1
1  1 309  802 1  1
1  805 1  1 409  1
1  1   1  1   1  1
1  1   1  1   1  1
1  1 305  402 1  1
1 35 1      1 42 1
1 1  1      1  1 1
809  1  A   1  809
1 1 35      42 1 1
1 475        809 1
1  1         1 1 1
1  80000000009 1 1
1B 1         1 1 1
1  1         1 1 1
4021    B    1 805
  8:002   300:09  
  11  1   1  1 1  
3051  1   1  1 1  
1  1  40705  475  
1  1    1     1   
8009 A  1  C  1   
1  1    1     1   
4705 3006000009   
 1   1        1   
 402 4002     8002
   1    1     1  1
   1    1  3005  1
   800009  1     1
   1    1  1 B 309
   1 C  4775   1 1
3009     11    1 1
1  1   305407005 1
1  80009    1    1
1  1   1    1    1
1  1   1    1 A  1
1  1 B 1    1    1
1  1   1    1  305
4705   470706709  
 1      1 1  1 402
 47000005 1  1   1
  1       1  1   1
  800000006009   1
  1          1   1
  1 C   A    1   1
  400000070705 B 1
         1 1     1
  30007005 4007005
309   1       1   
1 1 C 1       1   
1 1   1   B   1   
1 1   1       1   
1 40705  300006002
1   1    1       1
4000600009       1
         1       1
     A   1       1
   3007009  D    1
   1  1  1       1
   1  1  400070705
   8009      1 1  
   1  1   B  1 1  
C  1  1      1 1  
   800600702 809  
   1     1 1 1 1  
   40070060675 1  
      1     1  1  
   B  1  A  1  1  
      1     1  1  
   300670707670602
   1   1 1 1 1   1
   80005 1 1 40009
   1     1 1     1
   1  3005 4002  1
   1  1       1  1
   4075       4705
     1         1  
     1   D     1C 
   B 40000;00005  
          1       
          1       
          1       
          1       
*
  1 111 11111111111111111111111 111 
                                    
  1   1                       1   1 
  1   1                       1   1 
  1   1 11115           5 11111   1 
  1                               1 
  1         1           1         1 
  1         1           1         1 
  4 11111   1           1   1 11114 
            1           1           
        1 111 111 111 111 111       
                                    
                1   1               
                1   1               
        6 1111111   1 1111116       
                                    
        1                   1       
        1                   1       
  1 11111                   1 11111 
                                    
  1     1     1 11< 111     1     1 
  1     1                   1     1 
  1     2 11111   1   1 11112     1 
  1               1               1 
  1               1               1 
  1               1               1 
  1               1               1 
  1               1               1 
  4 111111111     1 11111 111111114 
                                    
            1     1     1           
            1     1     1           
  1 111111111     1     1 111111111 
                  1                 
  1         1     1     1         1 
  1         1     1     1         1 
  1     1 111 11115     1 111     1 
  1                               1 
  1     1         1         1     1 
  1     1         1         1     1 
  1 11118 111     1     1 117 11111 
                  1                 
  1         1     1     1         1 
  1         1     1     1         1 
  1         1     1     1 111     1 
  1         1     1               1 
  1         1     1     1   1     1 
  1         1     1     1   1     1 
  1 11111   1     1     1   1 11111 
            1     1     1           
        1 111 1 11> 111 1           
                                    
              1       1             
              1       1             
      1 1111111       1 1111111     
                                    
      1                       1     
      1                       1     
      1                       1     
      1                       1     
1 11116 1                 1 116 111 
                                    
1       1                 1       1 
1       1                 1       1 
1       1                 1       1 
1       1                 1       1 
1 11111 1 11111     1 11111 1 11111 
                                    
1     1       1     1       1     1 
1     1       1     1       1     1 
1     1   1 111     1 111   1     1 
1     1                     1     1 
1     1 111   1     1   1 111     1 
1             1     1             1 
1     1       1     1       1     1 
1     1       1     1       1     1 
1     1       1     1       1     1 
1     1       1     1       1     1 
1     1   1 11<     2 111   1     1 
1     1                     1     1 
1   1 1   1             1   1 1   1 
1         1             1         1 
1   1     1             1     1   1 
1   1     1             1     1   1 
6 111     1             1     1 115 
          1             1           
1   1   1 1             1 1   1   1 
1   1                         1   1 
1   1 1 1                 1 111   1 
1                                 1 
1     1                   1   1   1 
1     1                   1   1   1 
1     1 1111111117111111111   1   1 
1                             1   1 
1     1                   1   1   1 
1     1                   1   1   1 
1     1                   1   1   1 
1     1                   1   1   1 
1 111 1                   1   1 111 
      1                   1         
    : 1 11111       1 11111 111     
                                    
    1 1     1       1     1   1     
    1 1     1       1     1   1     
1 111 1     1       1     1   1     
      1     1       1     1   1     
1     1     1 11; 111     1 4 1     
1     1                             
1     1         1           1       
1     1         1           1       
1 11111         1           1       
                1           1       
1     1         1           1       
1     1         1           1       
1 5 111   1 11111 11111111111       
                                    
  1       1                 1       
  1       1                 1       
  1 111   1 11111           1 11111 
                                    
      1         1           1     1 
      1         1           1     1 
      1         1     1 11111     1 
      1         1                 1 
      1 111111111     1           1 
                      1           1 
      1         1     1       1 113 
      1         1     1             
      1         1 1 1 1       1   1 
      1                       1   1 
1 11111           1 1         1   1 
                  1 1         1   1 
1     1       1 111 1 111 11111   1 
1     1                           1 
1     1 1111111         1         1 
1                       1         1 
1     1       1         1         1 
1     1       1         1         1 
1     1       1         1         1 
1     1       1         1         1 
1     1       1         1         1 
1     1       1         1         1 
1     1       1         1     1 111 
1     1       1         1           
1 8 111       1 1 112 111 1 111     
                                    
  1             1   1     1   1 111 
  1             1   1     1         
  1 1 11111111111   1     1       1 
                    1     1       1 
    1               1     1       1 
    1               1     1       1 
    1 111111111111111 11111       1 
                                  1 
    1                     1       1 
    1                     1       1 
    1                     1       1 
    1                     1       1 
    1 1111111111111 111 111       1 
                                  1 
                  1   1           1 
                  1   1           1 
    1 111111; 11111   1 1111< 11111 
                                    
1 111       1               1       
            1               1       
1   1       1               1       
1   1       1               1       
1   1       1               1       
1   1       1               1       
1   1       1               1       
1   1       1               1       
1   1 111 111     6 111111111 11115 
1                                   
1       1         1               1 
1       1         1               1 
1 1111111 111111111               1 
                                  1 
                  1               1 
                  1               1 
                  1               1 
                  1               1 
      1 1111= 11111               1 
                                  1 
      1     1     1               1 
      1     1     1               1 
      1     1     5 1111111 111 116 
      1     1                       
      1 11111             1   1     
                          1   1     
      1     1             1   1     
      1     1             1   1     
      1     1             1   1     
      1     1             1   1     
      1 11111 11111 111   1 111     
                                    
      1           1   1   1   1     
      1           1   1   1   1     
      4 11111 11111 111 1 1   1     
                              1     
            1           1     1     
            1           1     1     
            1           1     1     
            1           1     1     
            1           1     1     
            1           1     1     
      1 11111 1 114 114 1 1 111 111 
                                    
      1       1   1   1   1       1 
      1       1   1   1   1       1 
      1 1111111   1   1   1 1111111 
                  1   1             
      1           1   1           1 
      1           1   1           1 
      1     1 11118   7 11111     1 
      1                           1 
      1     1               1     1 
      1     1               1     1 
      1 111 1               1 1 111 
                                    
          1                   1     
          1                   1     
          1                   1     
          1                   1     
          1 11111111  111111111     
                                    
                                    
                                    
                                    
                                    
                                    
                                    
                                    
                                    
*