Textures/classic9.bmp
0 0
7 84
0
3070000002        
1 1      1        
1 1      1        
4767070075        
 1 1 1  1         
 1 1 8009         
 80:09  1         
 1 1 1  1         
36760600:002      
1 1     1  1      
1 1     1  1      
80670700:075      
1  1 1  1 1       
8009 1  1 1       
1  1 800:09       
1  1 1  1 1       
80760607676002    
1 1    1 1   1    
1 1    1 1   1    
4760700:0:0709    
 1  1  1 1 1 1    
 1  1  1 1 1 1    
36076076060:09    
1  1  1    1 1    
1  1  802  809    
1  1  1 1  1 1    
800600:0600609    
1     1      1    
1     1      1    
80707060707006002 
1 1 1   1 1     1 
40606070:0:000705 
      1 1 1   1   
      1 1 1   1   
     36767600062  
     1 1 1     1  
     1 1 1     1  
     47606000709  
      1      1 1  
 30070:0700706062 
 1  1 1 1  1    1 
 1  1 1 1  1    1 
 8006060:00:00709 
 1      1  1  1 1 
 8070007600600:09 
 1 1   1      1 1 
 8060709      809 
 1   1 1      1 1 
 4707606000707675 
  1 1      1 1 1  
  1 1      1 1 1  
  1 1      1 1 1  
  4760070706060602
   1   1 1       1
   1   1 1       1
   400767670070075
      1 1 1  1  1 
      1 1 1  1  1 
      80:0:0060762
      1 1 1    1 1
      809 1    809
      1 809    1 1
      1 1 1    1 1
      806767000:09
      1  1 1   1 1
      8009 8000:09
      1  1 1   1 1
   300670:0:070609
   1   1 1 1 1   1
   800060676060009
   1      1      1
   1      1      1
   1      1      1
300670007067007009
1   1   1  1  1  1
80006700:006706009
1    1  1   1    1
1    1  1   1    1
4000060;6000600005
       1          
       1          
       1          
       1          
       1          
*
1 111 1111611111111                 
                                    
1   1             1                 
1   1             1                 
1   1             1                 
1   1             1                 
1 1 1 1 111 11111 1                 
                                    
  1   1   1     1                   
  1   1   1     1                   
  1   1   1 11111                   
  1   1                             
  1 111 111     1                   
                1                   
  1   1   1     1                   
  1   1   1     1                   
1 6 1 1 111 11111 11111             
                                    
1   1           1     1             
1   1           1     1             
1   1           1     1             
1   1           1     1             
1 111 1 111 11111 211 1             
                                    
1     1   1     1   1               
1     1   1     1   1               
1 11111   1     1   1               
          1     1   1               
1     1   1 11111 111               
1     1                             
1     1   1     1   1               
1     1   1     1   1               
1 411 1 111 111 1 1 1 11111         
                                    
1   1         1   1       1         
1   1         1   1       1         
1   1         1   1       1         
1   1         1   1       1         
1 1 1 111 11111 111 >11 111         
                                    
  1     1     1   1   1   1         
  1     1     1   1   1   1         
  1     1     1   1   1   1         
  1     1     1   1   1   1         
1 1 111 1 111 5 111 111 111         
                                    
1     1     1         1   1         
1     1     1         1   1         
1     1     1 111     1 111         
1     1                             
1     1     1   1     1   1         
1     1     1   1     1   1         
1 11111 :1111 111 11111 111         
                                    
1           1             1         
1           1             1         
1           1             1         
1           1             1         
1 111 111 511 111 111 11111 11111   
                                    
1   1   1       1   1           1   
1   1   1       1   1           1   
1 111 111 111 111 111 1111111 111   
                                    
            1   1   1       1       
            1   1   1       1       
            1   1   1       1       
            1   1   1       1       
          1 1 1 1 1 4 1111111 1     
                                    
          1   1   1           1     
          1   1   1           1     
          1   1   1           1     
          1   1   1           1     
          1 1 1 111 4111111 111     
                                    
            1             1   1     
            1             1   1     
  1 11112 111 111 11111 111 111 1   
                                    
  1     1   1   1     1         1   
  1     1   1   1     1         1   
  1     1   1   1     1         1   
  1     1   1   1     1         1   
  1 11111 411 111 11111 11111 111   
                                    
  1             1     1     1   1   
  1             1     1     1   1   
  1 117 1111111 1 11111 11111 111   
                                    
  1   1       1             1   1   
  1   1       1             1   1   
  1 111 111 111             1 111   
                                    
  1       1   1             1   1   
  1       1   1             1   1   
  1 3 111 1 111 1111111 111 1 1 1   
                                    
    1   1             1   1   1     
    1   1             1   1   1     
    1   1             1   1   1     
    1   1             1   1   1     
    1   1             1   1   1     
    1   1             1   1   1     
    1 1 < 11111 111 111 111 111 111 
                                    
      1       1   1               1 
      1       1   1               1 
      1       1   1               1 
      1       1   1               1 
      1 11111 1 1 1 1 11111 11611 1 
                                    
            1   1   1     1     1   
            1   1   1     1     1   
            1   1   1     1     1   
            1   1   1     1     1   
            1 111 111 11211 111 1 1 
                                    
            1   1   1         1   1 
            1   1   1         1   1 
            1 111   1         1 111 
                    1               
            1   1 111         1   1 
            1                 1   1 
            1   1   1         1   1 
            1   1   1         1   1 
            1 115 1 1 1 1111111 111 
                                    
            1     1   1       1   1 
            1     1   1       1   1 
            1 11111   1 1111111 111 
                                    
            1     1   1       1   1 
            1     1   1       1   1 
      1 11111 1 111 111 111 111 111 
                                    
      1       1   1   1   1       1 
      1       1   1   1   1       1 
      1 1151111 111 1 1 111 1111111 
                                    
      1             1             1 
      1             1             1 
      1             1             1 
      1             1             1 
      1             1             1 
      1             1             1 
1 11111 1 1111111 111 1 11411 11111 
                                    
1       1       1     1     1     1 
1       1       1     1     1     1 
1 1111111 1 11111 11111 1 111 11111 
                                    
1         1     1       1         1 
1         1     1       1         1 
1         1     1       1         1 
1         1     1       1         1 
1 111111111 11111 1111111 111111111 
                                    
                                    
                                    
                                    
                                    
                                    
                                    
                                    
                                    
                                    
                                    
*