Textures/classic10.bmp
1 0
7 95
0
30707007002       
1 1 1  1  1       
1 1 1  1  1       
1 1 1  1  1       
1 1 1  1  1       
4060:00:075       
    1  1 1        
    1  1 1        
    1  1 1        
3070600:062       
1 1    1  1       
1 1    1  1       
40:0070:009       
  1  1 1  1       
  80767600602     
  1 1 1     1     
  80676700005     
  1  1 1          
  1  1 1          
  8076767002      
  1 1 1 1  1      
  1 1 1 1  1      
  1 1 1 1  1      
  40:0:0:075      
    1 1 1 1       
    1 1 1 1       
    1 1 1 1       
3007676060602     
1  1 1      1     
1  1 1      1     
1  1 1      1     
470:0600700762    
 1 1    1  1 1    
 1 1    1  1 1    
 1 1    1  1 1    
3676700060060602  
1 1 1          1  
1 1 1          1  
809 800070007009  
1 1 1   1   1  1  
8060:0006070:075  
1   1     1 1 1   
1   1     1 1 1   
40076700706060:002
   1 1  1     1  1
   1 1  1     1  1
   1 1  1     1  1
   406076000706709
       1    1  1 1
       1    1  1 1
       80707600609
       1 1 1     1
       1 1 1     1
       1 1 1     1
       40:06707075
         1  1 1 1 
         1  1 1 1 
        3670606062
        1 1      1
        809      1
        1 80000009
        1 1      1
        4767007075
         1 1  1 1 
     3007606006062
     1  1        1
     1  1        1
   30600:007007009
   1    1  1  1  1
   80700:006006009
   1 1  1        1
   806009        1
   1    1        1
   80000:070070009
   1    1 1  1   1
   80000:0:0060075
   1    1 1     1 
   1    1 1     1 
300:0000:067007062
1  1    1  1  1  1
1  1    1  1  1  1
1  1    1  1  1  1
80060070:00600:009
1     1 1     1  1
1     1 1     1  1
1     1 1     1  1
80070060:007006009
1  1    1  1     1
1  1    1  1     1
1  1    1  1     1
4006000;6006000005
       1          
       1          
       1          
       1          
       1          
*
1 111 111 11111 11116               
                                    
1   1   1     1     1               
1   1   1     1     1               
1   1   1     1     1               
1   1   1     1     1               
1   1   1     1     1               
1   1   1     1     1               
1   1   1     1     1               
1   1   1     1     1               
1 111 111 11111 111 1               
                                    
        1     1   1                 
        1     1   1                 
        1     1   1                 
        1     1   1                 
        1     1   1                 
        1     1   1                 
1 111 511 11111 111 1               
                                    
1   1         1     1               
1   1         1     1               
1   1         1     1               
1   1         1     1               
1 111 11111 111 11112               
                                    
    1     1   1     1               
    1     1   1     1               
    1 511 1 1 1 11111 111           
                                    
    1   1   1           1           
    1   1   1           1           
    1 118 1 1 1 111111111           
                                    
    1     1   1                     
    1     1   1                     
    1     1   1                     
    1     1   1                     
    1 111 1 1 1 1 11113             
                                    
    1   1   1   1     1             
    1   1   1   1     1             
    1   1   1   1     1             
    1   1   1   1     1             
    1   1   1   1     1             
    1   1   1   1     1             
    1 111 111 111 >11 1             
                                    
        1   1   1   1               
        1   1   1   1               
        1   1   1   1               
        1   1   1   1               
        1   1   1   1               
        1   1   1   1               
1 11111 1 1 1 113 111 111           
                                    
1     1   1             1           
1     1   1             1           
1     1   1             1           
1     1   1             1           
1     1   1             1           
1     1   1             1           
1 1 111 211 11111 11111 1 1         
                                    
  1   1         1     1   1         
  1   1         1     1   1         
  1   1         1     1   1         
  1   1         1     1   1         
  1   1         1     1   1         
  1   1         1     1   1         
1 1 1 1 1 1111111 11411 111 111     
                                    
1   1   1                     1     
1   1   1                     1     
1   1   1                     1     
1   1   1                     1     
1 111   1 1111111 1111111 11111     
                                    
1   1   1       1       1     1     
1   1   1       1       1     1     
1 111 111 1111111 111 111 111 1     
                                    
1       1           1   1   1       
1       1           1   1   1       
1       1           1   1   1       
1       1           1   1   1       
1 11111 1 1 11115 111 111 111 11111 
                                    
      1   1     1           1     1 
      1   1     1           1     1 
      1   1     1           1     1 
      1   1     1           1     1 
      1   1     1           1     1 
      1   1     1           1     1 
      1 111 111 1 1111B11 111 1 111 
                                    
              1         1     1   1 
              1         1     1   1 
              1         1     1   1 
              1         1     1   1 
              1 111 114 1 11111 111 
                                    
              1   1   1           1 
              1   1   1           1 
              1   1   1           1 
              1   1   1           1 
              1   1   1           1 
              1   1   1           1 
              1 112 111 1 111 111 1 
                                    
                  1     1   1   1   
                  1     1   1   1   
                  1     1   1   1   
                  1     1   1   1   
                1 1 5 111 111 111 1 
                                    
                1   1             1 
                1   1             1 
                1 111             1 
                                  1 
                1   1 1111111111111 
                1                   
                1   1             1 
                1   1             1 
                1 1 1 1 11111 117 1 
                                    
                  1   1     1   1   
                  1   1     1   1   
          1 11111 4 111 11111 111 1 
                                    
          1     1                 1 
          1     1                 1 
          1     1                 1 
          1     1                 1 
      1 111 11111 11111 11111 11111 
                                    
      1         1     1     1     1 
      1         1     1     1     1 
      1 111 1111: 11111 11111 11111 
                                    
      1   1     1                 1 
      1   1     1                 1 
      1 111 11111                 1 
                                  1 
      1         1                 1 
      1         1                 1 
      1 111111411 111 11111 1111111 
                                    
      1         1   1     1       1 
      1         1   1     1       1 
      1 111111111 111 21111 11111 1 
                                    
      1         1   1           1   
      1         1   1           1   
      1         1   1           1   
      1         1   1           1   
1 11111 111111111 311 1 11111 111 1 
                                    
1     1         1     1     1     1 
1     1         1     1     1     1 
1     1         1     1     1     1 
1     1         1     1     1     1 
1     1         1     1     1     1 
1     1         1     1     1     1 
1 11111 11111 111 11111 11111 11111 
                                    
1           1   1           1     1 
1           1   1           1     1 
1           1   1           1     1 
1           1   1           1     1 
1           1   1           1     1 
1           1   1           1     1 
1 11111 11111 111 31111 11111 11111 
                                    
1     1         1     1           1 
1     1         1     1           1 
1     1         1     1           1 
1     1         1     1           1 
1     1         1     1           1 
1     1         1     1           1 
1 11111 111111111 11111 11111111111 
                                    
                                    
                                    
                                    
                                    
                                    
                                    
                                    
                                    
                                    
                                    
*