Textures/classic3.bmp
0 0
11 61
0
3070000700070002   
1 1    1   1   1   
1 1    1   1   1   
80:002 800060009   
1 1  1 1       1   
1 1  1 1       1   
8067067600700709   
1  1  1   800:05   
800:00:0005  1     
1  1  1      1     
400:0060007009     
   4707000:009     
    1 1   1  1     
    1 1   1  1     
    8060076009     
    1    1   1     
    8007060009     
    1  1     1     
    800:007009     
    1  1  1  1     
    8009  8009     
    1  1  1  1     
  305  1  1  1     
  40070600:0762    
     1    1 1 1    
   309    1 1 1    
   1 800009 409    
   1 1    1   1    
   4760000:000602  
    1     1     1  
    8000706000709  
    1   1     1 1  
    4070670700605  
      1  1 1       
      1  1 1       
      800609       
      1    1       
      80707602     
      1 809  1     
 30700:05 8009     
 1 1  1   1  1     
 1 1  1   1  1     
 40:00:000:009     
   1  1   1  1     
   1  1   1  1     
   400:0006709     
      1    1 1     
      800009 1     
      1    80602   
      1    1   1   
      8007060709   
      1  1   1 1   
      4076070:09   
        1  1 1 1   
       36009 1 1   
       1   1 1 1   
       1   809 1   
       470060609   
        1      1   
        400;0005   
           1       
           1       
*
1 111 111111111 1111111 1111111       
                                      
1   1         1       1       1       
1   1         1       1       1       
1   1         1       1       1       
1   1         1       1       1       
1 111 11111   1 1111111 1111111       
                                      
1   1     1   1               1       
1   1     1   1               1       
1   1     1   1               1       
1   1     1   1               1       
1 111 1 111 1 1 11111 11111 111       
                                      
1     1     1       1 11111 112       
1     1     1                         
1 11111 11111 1111111     1           
                          1           
1     1     1             1           
1     1     1             1           
1 11111 11111 1111111 11111           
                                      
      1 1 111 1111111 11111           
                                      
        1   1       1     1           
        1   1       1     1           
        1   1       1     1           
        1   1       1     1           
        1 111 11111 1 11111           
                                      
        1         1       1           
        1         1       1           
        1 11111 111 1111111           
                                      
        1     1           1           
        1     1           1           
        1 11111 11111 11111           
                                      
        1     1     1     1           
        1     1     1     1           
        1 11111     1 11111           
                                      
        1     1     1     1           
        1     1     1     1           
    1 113     1     1     1           
              1     1     1           
    1 11111 111 11111 111 1 1         
                                      
          1         1   1   1         
          1         1   1   1         
      1 111         1   1   1         
                    1   1   1         
      1   1 111111111   1 111         
      1                               
      1   1         1       1         
      1   1         1       1         
      1 1 1 111111111 1111111 112     
                                      
        1           1           1     
        1           1           1     
        1 1111111 111 1111111 111     
                                      
        1       1           1   1     
        1       1           1   1     
        1 111 111 1 111 11111 111     
                                      
            1     1   1               
            1     1   1               
            1     1   1               
            1     1   1               
            1 11111 111               
                                      
            1         1               
            1         1               
            1 111 111 1 111           
                                      
            1   1 111     1           
            1             1           
  1 111 11111 11>   1 11111           
                                      
  1   1     1       1     1           
  1   1     1       1     1           
  1   1     1       1     1           
  1   1     1       1     1           
  1 111 11111 1111111 11111           
                                      
      1     1       1     1           
      1     1       1     1           
      1     1       1     1           
      1     1       1     1           
      1 11111 1111111 1 111           
                                      
            1         1   1           
            1         1   1           
            1 111111111   1           
                          1           
            1         1 111 111       
            1                         
            1         1       1       
            1         1       1       
            1 11111 111 111 111       
                                      
            1     1       1   1       
            1     1       1   1       
            4 111 1 111 111 111       
                                      
                1     1   1   1       
                1     1   1   1       
              1 1 11111   1   1       
                          1   1       
              1       1   1   1       
              1       1   1   1       
              1       1 111   1       
              1               1       
              1 1 11111 111 111       
                                      
                1             1       
                1             1       
                1 11111 1111111       
                                      
                                      
                                      
                                      
                                      
*