Textures/town2.bmp
9 0
9 77
0
       30002      
       1   1      
  300009   800002 
  1    1K  1    1 
  1    40705    1 
  1      1      1 
  1 C    1   I  1 
 36070000600007062
 1  1         1  1
 1F 1G      G 1F 1
 8009         8009
 1  1         1  1
 1  1   A     1  1
 80060000700006009
 1       1       1
 1       1       1
 1  E    1   E   1
 80000000600000009
 1               1
 1F G    H   G F 1
 1               1
 8000002   3000009
 1     1 E 1     1
 1     1   1     1
 1     1   1     1
 1 A   1E  1 A   1
 800000:000:000009
 1     1   1     1
 1     1E  1     1
 1     1   1     1
 1 A   1   1 A   1
 8000705 E 4070009
 1   1       1   1
 1 G 1       1 G 1
 80009       80009
 1   1   H   1   1
 1 E 1       1 E 1
 80006070007060009
 1     1   1     1
 1     1 H 1     1
 1  E  1   1  E  1
 8000009   8000009
 1     1   1     1
 1  G  1   1  G  1
 8000009   8000009
 1     1   1     1
 1     1E  1     1
 1  C  1   1  K  1
 400000:000:000005
       1   1      
       1   1      
     E 1D  1E     
 300000:000:000002
 1     1   1     1
 1 G   1   1  G  1
 8000009   8000009
 1     1B  1     1
 1  F  1   1 F   1
 800700:000:007009
 1  1  1   1  1  1
 1E 1  1   1  1E 1
 8006009   8006009
 1     1K  1     1
 1 G   1   1  G  1
 80000060706000009
 1       1       1
 1     F 1F      1
 1  B    1  C    1
 80007000600070009
 1   1       1   1
 1   1  H    1   1
 1   1       1   1
 40006000;00060005
         1        
 F     G 1G     F 
    L    1   J    
         1        
         1        
*
              1 1111111             
                                    
              1       1             
              1       1             
    1 111111111       1 111111111   
                                    
    1         1       1         1   
    1         1       1         1   
    1         1 111 111         1   
    1                           1   
    1             1             1   
    1             1             1   
    1             1             1   
    1             1             1   
  1 1 111 111111111 111111111 111 1 
                                    
  1     1                   1     1 
  1     1                   1     1 
  1     1                   1     1 
  1     1                   1     1 
  1 11111                   1 11111 
                                    
  1     1                   1     1 
  1     1                   1     1 
  1     1                   1     1 
  1     1                   1     1 
  5 11111 111111111 111111111 11115 
                                    
  1               1               1 
  1               1               1 
  1               1               1 
  1               1               1 
  1               1               1 
  1               1               1 
  1 11111111111111: 111111111111111 
                                    
  1                               1 
  1                               1 
  1                               1 
  1                               1 
  1                               1 
  1                               1 
  1 11111111112       2 11111111111 
                                    
  1           1       1           1 
  1           1       1           1 
  1           1       1           1 
  1           1       1           1 
  1           1       1           1 
  1           1       1           1 
  1           1       1           1 
  1           1       1           1 
  1 11111111111 1111111 11111111111 
                                    
  1           1       1           1 
  1           1       1           1 
  1           1       1           1 
  1           1       1           1 
  1           1       1           1 
  1           1       1           1 
  1           1       1           1 
  1           1       1           1 
  1 1111111 113       3 111 1111111 
                                    
  1       1               1       1 
  1       1               1       1 
  1       1               1       1 
  1       1               1       1 
  1 1111111               1 1111111 
                                    
  1       1               1       1 
  1       1               1       1 
  1       1               1       1 
  1       1               1       1 
  1 1111111 111 111=111 111 1111111 
                                    
  1           1       1           1 
  1           1       1           1 
  1           1       1           1 
  1           1       1           1 
  1           1       1           1 
  1           1       1           1 
  5 11111111111       1 11111111115 
                                    
  1           1       1           1 
  1           1       1           1 
  1           1       1           1 
  1           1       1           1 
  1 11111111111       1 11111111111 
                                    
  1           1       1           1 
  1           1       1           1 
  1           1       1           1 
  1           1       1           1 
  1           1       1           1 
  1           1       1           1 
  1 11111111111 111:111 11111111111 
                                    
              1       1             
              1       1             
              1       1             
              1       1             
              1       1             
              1       1             
  3 11111111111 1111111 11111111113 
                                    
  1           1       1           1 
  1           1       1           1 
  1           1       1           1 
  1           1       1           1 
  1 11111111111       1 11111111111 
                                    
  1           1       1           1 
  1           1       1           1 
  1           1       1           1 
  1           1       1           1 
  2 11111 11111 1111111 11111 11112 
                                    
  1     1     1       1     1     1 
  1     1     1       1     1     1 
  1     1     1       1     1     1 
  1     1     1       1     1     1 
  1 11111 11111       1 11111 11111 
                                    
  1           1       1           1 
  1           1       1           1 
  1           1       1           1 
  1           1       1           1 
  1 11111111111 117 111 11111111111 
                                    
  1               1               1 
  1               1               1 
  1               1               1 
  1               1               1 
  1               1               1 
  1               1               1 
  4 1111111 1111111 1111111 1111114 
                                    
  1       1               1       1 
  1       1               1       1 
  1       1               1       1 
  1       1               1       1 
  1       1               1       1 
  1       1               1       1 
  1 1111111 111111  1111111 1111111 
                                    
                                    
                                    
                                    
                                    
                                    
                                    
                                    
                                    
                                    
                                    
*