    1   1   1     
    1 D 1F  1     
    1   1   1     
 A  8000:0009  A  
    1   1   1     
    1F  1B  1     
    1   1   1     
    8000:000600002
    1   1        1
    1   1  B     1
 3005 F 8000007005
 1      1     1   
 80000009     1   
 1      1     1   
 1      8000006002
 80000009        1
 1      1F  C  F 1
 1 E    1        1
36000000:000000009
1       1        1
1D      1      D 1
1  30000:00002   1
1  1    1    1   1
4009  F 1F   80005
   1    1    1    
   40000:00005    
        1         
    A F 1F E      
        1         
  300000:000002   
  1     1     1   
  1F C  1 C F 1   
  1     1     1   
  400700:007005   
     1  1  1      
     1  1  1      
30000600:006000002
1       1        1
1 B   F 1F  D    1
40700000:000000705
  1     1      1  
  800000:0007005  
  1     1   1     
  1 A   1   1     
  1     1 E 1     
  1300009   1     
  11    1   1     
3069 C  80005     
1  1    1         
1F 40000:000070002
1       1    1   1
1       1    1   1
40070000:00009 A 1
   1    1    1   1
   1 B  1 D  80005
   1    1    1    
   80000:00009    
   1    1    1    
   1  F 1F   1    
   80000:00009    
   1    1    1    
   1 3009 C  1    
   1 1  1    40002
   409  1        1
     1  8000000009
     4009        1
        1 F B  F 1
      A 8000007009
        1     1  1
     3009   F 1  1
     1  1 D   1  1
     1  1     1  1
     4009   F 1  1
        800700:005
        1  1  1   

  1   1   1   1   
  1 D 1 A 1 B 1   
  1   1   1   1   
  1 B 1 F 1 D 1   
  1   1   1   1   
  1   1   1   1   
  8000607060009   
  1     1     1   
  1 C   1  C  1   
  1     1     1   
  1     1     1   
  607000:000709   
  1     1     1
800:000060000:009 
1  1         1  1 
4009    C    8005 
   1 E    B  1    
   1         1    
   40700000705    
     1     1      
     1     1      
 30709  A  80702  
 1 1 1     1 1 1  
 805 4007005 409  
 1      1      1  
 1   F  1  F   1  
 4000700:0070005  
     1  1  1      
     1  1  1      
  E  1  1  1 E    
     1  1  1      
 3000600:0060002  
 1      1      1  
 1   D  1 D    1  
 4702   1   3075  
  1 1   1   1 1   
  1 407060705 1   
  1   1   1   1   
  4007607067005   
     1  1  1      
  F  1  1  1  F   
300705  1  407002 
1  1    1    1  1 
1F 1D   1  B 1F 1 
1  1    1    1  1 
1  1B   1  D 1  1 
40067000600076005 
    1       1     
    1   A   1     
    4000;0005     
        1         
     F  1 F       
        1         
     F  1 F       
        1         
*
        1       1       1           
        1       1       1           
        1       1       1           
        1       1       1           
        1       1       1           
        1       1       1           
        1 1111112 1111111           
                                    
        1       1       1           
        1       1       1           
        1       1       1           
        1       1       1           
        1       1       1           
        1       1       1           
        5 1111111 1111111 111111111 
                                    
        1       1                 1 
        1       1                 1 
        1       1                 1 
        1       1                 1 
  1 11111       1 11111111113 11111 
                                    
  1             1           1       
  1             1           1       
  1 1111111111111           1       
                            1       
  1             1           1       
  1             1           1       
  1             1 11111111111 11111 
  1                                 
  1 1111111111111                 1 
                                  1 
  1             1                 1 
  1             1                 1 
  1             1                 1 
  1             1                 1 
1 7 1111111111111 11111111111111111 
                                    
1               1                 1 
1               1                 1 
1               1                 1 
1               1                 1 
1     1 111111111 111111111       1 
1                                 1 
1     1         1         1       1 
1     1         1         1       1 
1 11111         1         4 1111111 
                1                   
      1         1         1         
      1         1         1         
      1 11111111> 111111111         
                                    
                1                   
                1                   
                1                   
                1                   
                1                   
                1                   
    1 11111111111 11111111111       
                                    
    1           1           1       
    1           1           1       
    1           1           1       
    1           1           1       
    1           1           1       
    1           1           1       
    1 11115 11111 11114 11111       
                                    
          1     1     1             
          1     1     1             
          1     1     1             
          1     1     1             
1 111111111 11111 11111 11111111111 
                                    
1               1                 1 
1               1                 1 
1               1                 1 
1               1                 1 
1 111 11111111118 1111111111111 111 
                                    
    1           1             1     
    1           1             1     
    1 11111111111 1111111 11116     
                                    
    1           1       1           
    1           1       1           
    1           1       1           
    1           1       1           
    1           1       1           
    1           1       1           
    1 1 111111111       1           
    1                   1           
    1 1         1       1           
    1 1         1       1           
1 114 1         1 1111111           
                                    
1     1         1                   
1     1         1                   
1     1 11111111: 111111111 1111111 
1                                   
1               1         1       1 
1               1         1       1 
1               1         1       1 
1               1         1       1 
1 11111 111111111 111111111       1 
                                  1 
      1         1         1       1 
      1         1         1       1 
      1         1         1 1111111 
      1         1                   
      1         1         1         
      1         1         1         
      1 111111111 111111115         
                                    
      1         1         1         
      1         1         1         
      1         1         1         
      1         1         1         
      3 111111112 111111111         
                                    
      1         1         1         
      1         1         1         
      1   1 11111         1         
      1                   1         
      1   1     1         1 1111111 
      1   1     1                   
      1 111     1                 1 
                1                 1 
          1     1 11111111111111114 
          1                         
          ; 11111                 1 
                                  1 
                1                 1 
                1                 1 
                1 11111111118 11111 
                                    
                1           1     1 
                1           1     1 
          1 11111           1     1 
                            1     1 
          1     1           1     1 
          1     1           1     1 
          1     1           1     1 
          1     1           1     1 
          1 11111           1     1 
                            1     1 
                5 11111 11111 11111 
                                    
                1     1     1       
                1     1     1       

    1       1       1       1       
    1       1       1       1       
    1       1       1       1       
    1       1       1       1       
    1       1       1       1       
    1       1       1       1       
    1       1       1       1       
    1       1       1       1       
    1       1       1       1       
    1       1       1       1       
    1       1       1       1       
    1       1       1       1       
    1 1111111 111 111 1111111       
                                    
    1           1           1       
    1           1           1       
    1           1           1       
    1           1           1       
    1           1           1       
    1           1           1       
    1           1           1       
    1           1           1       
    1 111 111111; 1111111 111       
                                    
    1           1           1       
    1           1           1       
1 11111 111111112 111111111 11111   
                                    
1     1                   1     1   
1     1                   1     1   
6 11111                   1 11116   
                                    
      1                   1         
      1                   1         
      1                   1         
      1                   1         
      1 113 11111111115 111         
                                    
          1           1             
          1           1             
          1           1             
          1           1             
  1 111 111           1 111 111     
                                    
  1   1   1           1   1   1     
  1   1   1           1   1   1     
  1 111   1 11111 11111   1 111     
                                    
  1             1             1     
  1             1             1     
  1             1             1     
  1             1             1     
  1 1111111 11111 11111 1111111     
                                    
          1     1     1             
          1     1     1             
          1     1     1             
          1     1     1             
          1     1     1             
          1     1     1             
          1     1     1             
          1     1     1             
  3 1111111 11111 11111 1111114     
                                    
  1             1             1     
  1             1             1     
  1             1             1     
  1             1             1     
  1 1 111       1       1 111 1     
                1                   
    1   1       1       1   1       
    1   1       1       1   1       
    1   1 111 11= 111 111   1       
    1                       1       
    1       1       1       1       
    1       1       1       1       
    2 11111 1 111 111 1 11112       
                                    
          1     1     1             
          1     1     1             
          1     1     1             
          1     1     1             
1 11111 111     1     1 111 11111   
                1                   
1     1         1         1     1   
1     1         1         1     1   
1     1         1         1     1   
1     1         1         1     1   
1     1         1         1     1   
1     1         1         1     1   
1     1         1         1     1   
1     1         1         1     1   
                                    
1 11111 111111112 111111111 11111   