Textures/desert2.bmp
9 0
10 116
0
 30700700000700702
 1 1  1     1  1 1
 1 8009     8009 1
 1 1  1     1  1 1
 4062 1D    1 3605
    80607070609   
    1   1 1   1   
    80009 80075   
    1   1 1  1    
    1 B 1 1  1    
    1  36762 1    
    4075 1 475    
      1  1  1     
      8009  1 A   
    C 1  8009     
      1  1  1     
      1  1  802   
    30:009B 1 1   
    1 1  1  409   
    1 1  1    1   
   3609  8007062  
   1  1  1  1  1  
   1A 8009  80762 
   1  1  1C 1 1 1 
   42 1  1  1 475 
    806706075  1  
    1  1   1   1  
   36005   80009  
   1       1   1  
   1C      1B  1  
30062      4070602
1   1  D     1   1
1   1        1   1
80076002  30067009
1  1   1  1   1  1
1  1 309  802 1  1
1  805 1  1 409C 1
8009   1  1   8009
1  1 B 1  1   1  1
1  80705  40709  1
1 35 1      1 42 1
1 1  1      1  1 1
809  1  A   1  809
1 1 3602  3062 1 1
1 475  1  1  809 1
1  1   1  1C 1 1 1
800:0006006009 809
1  1         1 1 1
1C 1         1 1 1
1  1    B    1 805
800:002   300:09  
1  1  1   1  1 1  
1  1  1   1  1 1  
800:006070600675  
1  1    1     1   
8009 A  1  C  1   
1  1    1     1   
470607006007009   
 1   1     1  1   
 40706007009  1   
   1    1  1  1   
   1    1  8005   
   800009  1      
   1    1  1 B    
 309 C  47062     
 1 1     1  1     
 1 1   309  1     
360:0009 1  1     
1  1   806009     
8009   1    1 A   
1  1 B 1    1     
1  1   1    1     
47060006707062    
 1      1 1  1    
 47007009 1  1    
  1  1  1 1  1    
  470670606009    
   1  1      1    
   1C 1 A    1    
   40760070705    
     1   1 1      
    36700:062     
    1 1  1  1     
    1 1  1  1     
    1 800607602   
    809    1  1   
    1 800706006002
    1 1  1       1
    406709       1
       1 1       1
     A 1 1       1
   3007609  D    1
   1  1  1       1
   1  1  800070709
   8009  1   1 1 1
   1  1  1B  1 1 1
C  1  1  1   1 805
   800600:02 809  
   1     1 1 1 1  
   40070060675 1  
      1     1  1  
   B  1  A  8009  
      1     1  1  
   300670707670602
   1   1 1 1 1   1
   80075 1 1 47009
   1  1  1 1  1  1
   1  8005 4009  1
   1  1       1  1
   4075       4705
     1         1  
     1   D     1C 
   B 40000;00005  
          1       
          1       
          1       
          1       
*
  1 111 11111 11111111111 11111 111 
                                    
  1   1     1           1     1   1 
  1   1     1           1     1   1 
  1   1 11115           5 11111   1 
  1                               1 
  1   1     1           1     1   1 
  1   1     1           1     1   1 
  4 111 1   1           1   1 1 114 
            1           1           
        1 111 111 111 111 111       
                                    
        1       1   1       1       
        1       1   1       1       
        6 1111111   1 11111 6       
                                    
        1       1   1     1         
        1       1   1     1         
        1       1   1     1         
        1       1   1     1         
        1     1 1 < 1 1   1         
        1                 1         
        2 111 1   1   1 1 2         
                  1                 
            1     1     1           
            1     1     1           
            1 11111     1           
                        1           
            1     4 11111           
            1                       
            1     1     1           
            4     1     1           
            1     1     1 111       
            1     1                 
        1 111 11111     1   1       
                        1   1       
        1   1     1     1 111       
        1   1     5                 
        1   1     1         1       
        1   1     1         1       
      1 8 111     1 11111 117 1     
                                    
      1     1     1     1     1     
      1     1     1     1     1     
      1     1 11111     1 111 1 1   
      1                             
      1     1     1     1   1   1   
      1     1     1     1   1   1   
      1 1   1     1     1   1 1 1   
            1     1     1           
        1 111 1 11> 111 1     1     
                              1     
        1     1       1       1     
        1     1       1       1     
      1 1 11111       1 1111111     
                                    
      1               1       1     
      1               1       1     
      1               1       1     
      1               1       1     
1 11116 1             1 111 116 111 
                                    
1       1                 1       1 
1       1                 1       1 
1       1                 1       1 
1       1                 1       1 
1 11111 1 11111     1 11111 1 11111 
                                    
1     1       1     1       1     1 
1     1       1     1       1     1 
1     1   1 111     1 111   1     1 
1     1                     1     1 
1     1 111   1     1   1 111     1 
1             1     1             1 
1 11111       1     1       1 11111 
              1     1               
1     1       1     1       1     1 
1     1       1     1       1     1 
1     1 111 11<     2 111 111     1 
1                                 1 
1   1 1   1             1   1 1   1 
1         1             1         1 
1   1     1             1     1   1 
1   1     1             1     1   1 
6 111     1             1     1 115 
          1             1           
1   1   1 1 111     1 111 1   1   1 
1   1                         1   1 
1   1 1 1     1     1     1 111   1 
1             1     1             1 
1     1       1     1     1   1   1 
1     1       1     1     1   1   1 
1 11111 1111111 17111 11111   1 111 
                                    
1     1                   1   1   1 
1     1                   1   1   1 
1     1                   1   1   1 
1     1                   1   1   1 
1     1                   1   1 111 
1     1                   1         
: 11111 11111       1 11111 111     
                                    
1     1     1       1     1   1     
1     1     1       1     1   1     
1     1     1       1     1   1     
1     1     1       1     1   1     
1 11111 11111 11; 111 11111 4 1     
                                    
1     1         1           1       
1     1         1           1       
1 11111         1           1       
                1           1       
1     1         1           1       
1     1         1           1       
1 5 111 111 11111 11111 11111       
                                    
  1       1           1     1       
  1       1           1     1       
  1 111 111 11111 11111     1       
                            1       
      1         1     1     1       
      1         1     1     1       
      1         1     1 11113       
      1         1                   
      1 111111111     1             
                      1             
      1         1     1             
      1         1     1             
  1 111         1 1 111 1           
                                    
  1   1           1     1           
  1   1           1     1           
  1   1       1 111     1           
  1   1                 1           
1 1 111 1111111   1     1           
                  1     1           
1     1       1 111 11111           
1     1                             
1 11111       1         1           
              1         1           
1     1       1         1           
1     1       1         1           
1     1       1         1           
1     1       1         1           
1 8 111 1111111 1 112 111 1         
                                    
  1             1   1     1         
  1             1   1     1         
  1 1 11111 11111   1     1         
                    1     1         
    1     1     1   1     1         
    1     1     1   1     1         
    1 1 111 1 111 111 11111         
                                    
      1     1             1         
      1     1             1         
      1     1             1         
      1     1             1         
      1 111 1 11111 111 111         
                                    
          1       1   1             
          1       1   1             
        1 1 ; 11111 111 <           
                                    
        1   1     1     1           
        1   1     1     1           
        1   1     1     1           
        1   1     1     1           
        1   1 11111 111 1 111       
        1                           
        1 111         1     1       
                      1     1       
        1   1 11116 111 11111 11115 
        1                           
        1   1     1               1 
        1   1     1               1 
        1 111 1 111               1 
                                  1 
              1   1               1 
              1   1               1 
              1   1               1 
              1   1               1 
      1 1111= 1 111               1 
                                  1 
      1     1     1               1 
      1     1     1               1 
      1     1     5 1111111 111 116 
      1     1                       
      1 11111     1       1   1   1 
                  1       1   1   1 
      1     1     1       1   1   1 
      1     1     1       1   1   1 
      1     1     1       1   1 111 
      1     1     1       1         
      1 11111 11111 111   1 111     
                                    
      1           1   1   1   1     
      1           1   1   1   1     
      4 11111 11111 111 1 1   1     
                              1     
            1           1     1     
            1           1     1     
            1           1 11111     
            1                       
            1           1     1     
            1           1     1     
      1 11111 1 114 114 1 1 111 111 
                                    
      1       1   1   1   1       1 
      1       1   1   1   1       1 
      1 11111 1   1   1   1 1 11111 
                  1   1             
      1     1     1   1     1     1 
      1     1     1   1     1     1 
      1     1 11118   7 11111     1 
      1                           1 
      1     1               1     1 
      1     1               1     1 
      1 111 1               1 1 111 
                                    
          1                   1     
          1                   1     
          1                   1     
          1                   1     
          1 11111111  111111111     
                                    
                                    
                                    
                                    
                                    
                                    
                                    
                                    
                                    
*