Textures/classic10.bmp
1 0
7 95
0
30707007002       
1 1 1  1  1       
1 1 1  1  1       
1 1 1  1  1       
1 1 1  1  1       
4060:00:075       
    1  1 1        
    1  1 1        
    1  1 1        
3070600:062       
1 1    1  1       
1 1    1  1       
40:0070:009       
  1  1 1  1       
  80767600602     
  1 1 1     1     
  80676700005     
  1  1 1          
  1  1 1          
  807676700000002 
  1 1 1 1       1 
  1 1 1 1       1 
  1 1 1 1       1 
  40:0:0:07000005 
    1 1 1 1       
    1 1 1 1       
    1 1 1 1       
300767606060002   
1  1 1        1   
1  1 1        1   
1  1 1        1   
470:06007007075   
 1 1    1  1 1    
 1 1    1  1 1    
 1 1    1  1 1    
3676700060060602  
1 1 1          1  
1 1 1          1  
809 800000000009  
1 1 1          1  
8060:00000707075  
1   1     1 1 1   
1   1     1 1 1   
800060007060606002
1       1        1
1       1        1
1       1        1
400000076000700709
       1    1  1 1
       1    1  1 1
       80707600609
       1 1 1     1
       1 1 1     1
       1 1 1     1
       40:06707075
         1  1 1 1 
         1  1 1 1 
        3670606062
        1 1      1
        1 1      1
        1 1      1
        1 1      1
        4767007075
         1 1  1 1 
300000007606006062
1       1        1
1       1        1
1       1        1
1       1        1
80000000:000000009
1       1        1
1       1        1
1       1        1
80000000:000000009
1       1        1
80070000:070000075
1  1    1 1     1 
1  1    1 1     1 
80060000:060000062
1       1        1
1       1        1
1       1        1
80000000:000000009
1       1        1
1       1        1
1       1        1
80000000:007000009
1       1  1     1
1       1  1     1
1       1  1     1
4000000;6006000005
       1          
       1          
       1          
       1          
       1          
*
1 111 111 11111 11116               
                                    
1   1   1     1     1               
1   1   1     1     1               
1   1   1     1     1               
1   1   1     1     1               
1   1   1     1     1               
1   1   1     1     1               
1   1   1     1     1               
1   1   1     1     1               
1 111 111 11111 111 1               
                                    
        1     1   1                 
        1     1   1                 
        1     1   1                 
        1     1   1                 
        1     1   1                 
        1     1   1                 
1 111 511 11111 111 1               
                                    
1   1         1     1               
1   1         1     1               
1   1         1     1               
1   1         1     1               
1 111 11111 111 11112               
                                    
    1     1   1     1               
    1     1   1     1               
    1 511 1 1 1 11111 111           
                                    
    1   1   1           1           
    1   1   1           1           
    1 118 1 1 1 111111111           
                                    
    1     1   1                     
    1     1   1                     
    1     1   1                     
    1     1   1                     
    1 111 1 1 1 1 111111111111311   
                                    
    1   1   1   1               1   
    1   1   1   1               1   
    1   1   1   1               1   
    1   1   1   1               1   
    1   1   1   1               1   
    1   1   1   1               1   
    1 111 111 111 >11 11111111111   
                                    
        1   1   1   1               
        1   1   1   1               
        1   1   1   1               
        1   1   1   1               
        1   1   1   1               
        1   1   1   1               
1 11111 1 1 1 113 111 1111111       
                                    
1     1   1                 1       
1     1   1                 1       
1     1   1                 1       
1     1   1                 1       
1     1   1                 1       
1     1   1                 1       
1 1 111 211 11111 11111 111 1       
                                    
  1   1         1     1   1         
  1   1         1     1   1         
  1   1         1     1   1         
  1   1         1     1   1         
  1   1         1     1   1         
  1   1         1     1   1         
1 1 1 1 1 1111111 11411 111 111     
                                    
1   1   1                     1     
1   1   1                     1     
1   1   1                     1     
1   1   1                     1     
1 111   1 111111111111111111111     
                                    
1   1   1                     1     
1   1   1                     1     
1 111 111 11111111111 111 111 1     
                                    
1       1           1   1   1       
1       1           1   1   1       
1       1           1   1   1       
1       1           1   1   1       
1 1111111 1111115 111 111 111 11111 
                                    
1               1                 1 
1               1                 1 
1               1                 1 
1               1                 1 
1               1                 1 
1               1                 1 
1 1111111111111 1 1111B11 11111 111 
                                    
              1         1     1   1 
              1         1     1   1 
              1         1     1   1 
              1         1     1   1 
              1 111 114 1 11111 111 
                                    
              1   1   1           1 
              1   1   1           1 
              1   1   1           1 
              1   1   1           1 
              1   1   1           1 
              1   1   1           1 
              1 112 111 1 111 111 1 
                                    
                  1     1   1   1   
                  1     1   1   1   
                  1     1   1   1   
                  1     1   1   1   
                1 1 5 111 111 111 1 
                                    
                1   1             1 
                1   1             1 
                1   1             1 
                1   1             1 
                1   1             1 
                1   1             1 
                1   1             1 
                1   1             1 
                1 1 1 1 11111 117 1 
                                    
                  1   1     1   1   
                  1   1     1   1   
1 111111111111111 4 111 11111 111 1 
                                    
1               1                 1 
1               1                 1 
1               1                 1 
1               1                 1 
1               1                 1 
1               1                 1 
1               1                 1 
1               1                 1 
1 11111111111111: 11111111111111111 
                                    
1               1                 1 
1               1                 1 
1               1                 1 
1               1                 1 
1               1                 1 
1               1                 1 
1 111111111111411 11111111111111111 
                                    
1               1                 1 
1               1                 1 
1 11111 111111111 111 21111111111 1 
                                    
1     1         1   1           1   
1     1         1   1           1   
1     1         1   1           1   
1     1         1   1           1   
1 11111 111111111 311 11111111111 1 
                                    
1               1                 1 
1               1                 1 
1               1                 1 
1               1                 1 
1               1                 1 
1               1                 1 
1 111111111111111 11111111111111111 
                                    
1               1                 1 
1               1                 1 
1               1                 1 
1               1                 1 
1               1                 1 
1               1                 1 
1 111111111111111 31111 11111111111 
                                    
1               1     1           1 
1               1     1           1 
1               1     1           1 
1               1     1           1 
1               1     1           1 
1               1     1           1 
1 111111111111111 11111 11111111111 
                                    
                                    
                                    
                                    
                                    
                                    
                                    
                                    
                                    
                                    
                                    
*