Textures/classic4.bmp
8 5
8 78
0
  3000007000002   
  1     1     1   
  1     1     1   
  1     1     1   
  1     1     1   
  800000:000009   
  1     1     1   
  1     1     1   
  1     1     1   
  1     1     1   
  4007006000705   
     1      1     
     1      1     
     80000009     
     1      1     
300705      800002
1  1        1    1
1  1        1    1
1  80002    8702 1
1  1   1    11 409
4709   1    1402 1
 1 1   1    1  1 1
 1 40709    8009 1
 1   1 1    1  1 1
 1   1 1    1  809
 800060:2   1  1 1
 1     11 305  1 1
 1     1809  30609
 13070051 1  1   1
 8:060075 1  1   1
 11    1  800:02 1
 1400009  1  1 1 1
 1  3009 35  1 1 1
 1  1  1 1 3060:09
 1  1  1 421   1 1
 1  1  1  11   1 1
 4006705  11 305 1
     1    49 1   1
     1     80:0009
     1     1 1   1
 30006007009 1   1
 1      1  4060079
 1      1       11
 1    30:000070051
 800005 1    1   1
 1      1    1   1
 1      4002 1 309
 1         1 1 1 1
 4000000700:0:05 1
        1  1 1   1
        1  1 1   1
        1  1 1   1
        1  4280005
 3000000:000:5    
 1      1   1     
 1      1   1     
 40000009 305     
        1 1       
  300000:0600702  
  1     1    1 1  
  800000600005 1  
  1            1  
  80000000070005  
  1        1      
  1        1      
  400707000600002 
     1 1        1 
     1 1        1 
300706060002    1 
1  1       400009 
1  1            1 
1  40002     3009 
1      1     1  1 
40007006000705  1 
    1      1    1 
    4000;00600005 
        1         
        1         
        1         
*
    5 11111111111 11111111112       
                                    
    1           1           1       
    1           1           1       
    1           1           1       
    1           1           1       
    1           1           1       
    1           1           1       
    1           1           1       
    1           1           1       
    1 11111111111 11111111111       
                                    
    1           1           1       
    1           1           1       
    1           1           1       
    1           1           1       
    1           1           1       
    1           1           1       
    1           1           1       
    1           1           1       
    3 11111 11111 1111111 116       
                                    
          1             1           
          1             1           
          1             1           
          1             1           
          1 1111111111111           
                                    
          1             1           
          1             1           
7 11111 111             1 111111112 
                                    
1     1                 1         1 
1     1                 1         1 
1     1                 1         1 
1     1                 1         1 
1     1 1111115         1 1 111   1 
1                                 1 
1     1       1         1 1   1 111 
1     1       1         1 1         
1 1 111       1         1 1 111   1 
              1         1         1 
  1   1       1         1     1   1 
  1   1       1         1     1   1 
  1   1 111 111         1 11111   1 
  1                               1 
  1       1   1         1     1   1 
  1       1   1         1     1   1 
  1       1   1         1     1 111 
  1       1   1         1           
  1 1111111 111 1       1     1   1 
                        1     1   1 
  1           1 1   1 111     1   1 
  1           1 1             1   1 
  1           1 1 111     8 111 111 
  1           1                     
  1 1 111 11114 1   1     1       1 
  1             1   1     1       1 
  1 1 111 11111 1   1     1       1 
                    1     1       1 
  1 1         1     1 11111 111   1 
  1 1         1                   1 
  1 3 111111111     1     1   1   1 
  1                 1     1   1   1 
  1     1 11111   1 1     1   1   1 
  1                       1   1   1 
  1     1     1   1   1 111 111 111 
  1     1     1   1                 
  1     1     1   1 1 1       1   1 
  1     1     1       1       1   1 
  1     1     1     1 1       1   1 
  1     1     1     1 1       1   1 
  2 11111 1 111     1 1   1 111   1 
                    1 1           1 
          1         1 9   1       1 
          1               1       1 
          1           1 111 1111111 
          1                         
          1           1   1       1 
          1           1   1       4 
  5 1111111 11111 11111   1       1 
                          1       1 
  1             1     1 111 11111 1 
  1             1                   
  1             1               1 1 
  1             1               1 1 
  1         1 111 111111111 11111 1 
  1                               1 
  1 111111111   1         1       1 
                1         1       1 
  1             1         1       1 
  1             1         1       1 
  1             1 11111   1   1 111 
  1                       1         
  1                   1   1   1   1 
  1                   1   1   1   1 
  : 1111111111111 11111 111 111   1 
                                  1 
                1     1   1       1 
                1     1   1       1 
                1     1   1       1 
                1     1   1       1 
                1     1   1       1 
                1     1   1       1 
                1     1 1 1 1111112 
                1                   
  6 1111111111111 1111111 1         
                                    
  1             1       1           
  1             1       1           
  1             1       1           
  1             1       1           
  3 1111111111111   1 111           
                                    
                1   1               
                1   1               
    1 11111111111 111 11111 112     
                                    
    1           1         1   1     
    1           1         1   1     
    1 11111111111 111111111   1     
                              1     
    1                         1     
    1                         1     
    1 11111111111111111 1111111     
                                    
    1                 1             
    1                 1             
    1                 1             
    1                 1             
    2 11111 111 1111111 111111111   
                                    
          1   1                 1   
          1   1                 1   
          1   1                 1   
          1   1                 1   
1 11111 111 111 1111111         1   
                                1   
1     1               1 111111111   
1     1                             
1     1                         1   
1     1                         1   
1     1 1111111           1 11111   
1                                   
1             1           1     1   
1             1           1     1   
5 1111111 11111 1111111 111     1   
                                1   
        1             1         1   
        1             1         1   
        3 111111  11111 111111113   
                                    
                                    
                                    
                                    
                                    
                                    
                                    
*