     1    1   4002
     1 F  1      1
     1    1      1
 3000:0000:0000009
 1   1    1      1
 1   1    1  B   1
 1   1    1      1
 400067000:0000009
      1   1      1
      1 C 1    A 1
    F 1   1      1
      40009      1
          1      1
          1D     1
   3000000:0000009
   1      1      1
   1      1      1
   800070060007009
   1   1      1  1
   1   1  C   1  1
   40705      4075
     1  F   F   1 
     1          1 
 3000600700000009 
 1      1       1 
 1 A    1       1 
 1      1   E   1 
 1      1       1 
 4700000670007005 
  1      1   1    
  1 B    1   1    
  1    C 1 F 80002
  1      1   1   1
  4000000:0009 D 1
         1   1   1
         1   1   1
         1   1   1
   3000009 A 1   1
   1     1   1   1
   4007006000:0009
      1      1   1
      1F   B 1   1
      1      1   1
300000:00000060009
1     1          1
1     1          1
400000:000002  F 1
      1     1    1
  A   1     1 E  1
      1     1    1
300000:00000600009
1     1          1
1   F 1 B      D 1
1     1          1
800000600007000005
*

          1         1       1 11116 
          1         1               
          1         1             1 
          1         1             1 
          1         1             1 
          1         1             1 
  3 1111111 111111111 111111111111= 
                                    
  1       1         1             1 
  1       1         1             1 
  1       1         1             1 
  1       1         1             1 
  1       1         1             1 
  1       1         1             1 
  1 1111111 1 1111115 1111111111111 
                                    
            1       1             1 
            1       1             1 
            1       1             1 
            1       1             1 
            1       1             1 
            1       1             1 
            2 1111111             1 
                                  1 
                    1             1 
                    1             1 
                    1             1 
                    1             1 
      4 1111111111111 1111111111116 
                                    
      1             1             1 
      1             1             1 
      1             1             1 
      1             1             1 
      1 1111111 11111 1111111 11111 
                                    
      1       1             1     1 
      1       1             1     1 
      1       1             1     1 
      1       1             1     1 
      1 11: 111             1 11: 1 
                                    
          1                     1   
          1                     1   
          1                     1   
          1                     1   
  1 1111111 11111 111111111111111   
                                    
  1             1               1   
  1             1               1   
  1             1               1   
  1             1               1   
  1             1               1   
  1             1               1   
  1             1               1   
  1             1               1   
  1 1 11111111111 4 1111111 11111   
                                    
    1             1       1         
    1             1       1         
    1             1       1         
    1             1       1         
    1             1       1 111111: 
    1             1                 
    1             1       1       1 
    1             1       1       1 
    3 1111111111111 1111111       1 
                                  1 
                  1       1       1 
                  1       1       1 
                  1       1       1 
                  1       1       1 
                  1       1       1 
                  1       1       1 
      2 11111111111       1       1 
                          1       1 
      1           1       1       1 
      1           1       1       1 
      1 11111 11111 1111111 1111113 
                                    
            1             1       1 
            1             1       1 
            1             1       1 
            1             1       1 
            1             1       1 
            1             1       1 
5 11111111111 1111111111111 1111111 
                                    
1           1                     1 
1           1                     1 
1           1                     1 
1           1                     1 
1 11111111111 11111111118         1 
                                  1 
            1           1         1 
            1           1         1 
            1           1         1 
            1           1         1 
            1           1         1 
            1           1         1 
1 1111111111= 11111111111 111111111 
                                    
1           1                     1 
1           1                     1 
1           1                     1 
1           1                     1 
1           1                     1 
1           1                     1 
3 11111111111 111111111 11111111111 