Textures/classic2.bmp
4 0
12 70
0
    300007002     
    1    1  1     
    802  1  1     
    1 1  1  1     
    1 1  1  1     
    1 1  800:002  
    1 4009  1  1  
    1    1  1  1  
    1    1  1  1  
    80000:07:009  
    1    1 11  1  
    1    1 11  1  
    1    1 11  1  
    8000060:6005  
    1      1      
    1      1      
    8000070:000002
    400021 1     1
        11 1     1
        85 1     1
        1  1     1
        1  4007009
    30009     1  1
    40009     1  1
        1     1  1
        1     1  1
30000000:000006009
1       1      309
807000005    305 1
1 1      30009   1
1 1      1   40709
1 40007009     1 1
1     1  1     809
8002  1  1     1 1
1  1  1  1     1 1
1  400:009   309 1
1     1  1   1 1 1
40002 1  1   1 1 1
    1 1 360009 1 1
    80:05    80:09
    1 1      1 1 1
    1 1      1 1 1
 300:09 30070675 1
 1  1 1 1  1  1  1
 1  1 1 1  1  4075
 8009 80:009    1 
 1  1 1 1  1    1 
 1  1 1 1  1    1 
 400:0:0600:00005 
    1 1    1      
    1 1 32 1      
    1 1 11 400702 
    406091    1 1 
        89    1 1 
        1407005 1 
        1  1    1 
        1  1    1 
        800607009 
        1    1  1 
        8002 1  1 
        1  1 1  1 
   300075  40:005 
   1   1     1    
   1   80000060002
   1   1         1
   40009         1
       40000;00005
            1     
            1     
            1     
            1     
*
        1 111111111 11111           
                                    
        1         1     1           
        1         1     1           
        1 111     1     1           
                  1     1           
        1   1     1     1           
        1   1     1     1           
        1   1     1     1           
        1   1     1     1           
        1   1     1 11111 11111     
        1   1                       
        1   1 11111     1     1     
        1               1     1     
        1         1     1     1     
        1         1     1     1     
        1         1     1     1     
        1         1     1     1     
        1 111111111 111 1 11111     
                                    
        1         1   1 1     1     
        1         1   1 1     1     
        1         1   3 1     1     
        1         1   1 1     1     
        1         1   1 1     1     
        1         1   1 1     1     
        1 111111111 111 1 11112     
                                    
        1             1             
        1             1             
        1             1             
        1             1             
        1 111111111 115 11111111111 
                                    
        1 1111111 1   1           1 
                  1   1           1 
                1 1   1           1 
                1 1   1           1 
                1 1   1           1 
                      1           1 
                1     1           1 
                1     1           1 
                1     1 11111 11111 
                1                   
        1 1111116           1     1 
                            1     1 
        1 1111111           1     1 
                            1     1 
                1           1     1 
                1           1     1 
                1           1     1 
                1           1     1 
1 111111111111111 1111111111> 11111 
                                    
1               1             1 111 
1               1                   
1 111 11111111112         1 111   1 
                                  1 
1   1             1 1111111       1 
1   1                             1 
1   1             1       1 111 111 
1   1             1                 
1   1 111111: 11111           1   1 
1                             1   1 
1           1     1           5 111 
1           1     1                 
1 11111     1     1           1   1 
            1     1           1   1 
1     1     1     1           1   1 
1     1     1     1           1   1 
1     1 11111 11111       1 111   1 
1                                 1 
1           1     1       1   1   1 
1           1     1       1   1   1 
1 1111111   1     1       1   1   1 
            1     1       1   1   1 
        1   1   7 1 1111111   1   1 
        1   1                 1   1 
        1 114 111         1 111 111 
                                    
        1   1             1   1   1 
        1   1             1   1   1 
        1   1             1   1   1 
        1   1             1   1   1 
  1 11111 111   1 11111 111 5 1   1 
                                  1 
  1     1   1   1     1     1     1 
  1     1   1   1     1     1     1 
  1     1   1   1     1     1 111 1 
  1     1   1   1     1             
  1 11111   1 111 11111         1   
                                1   
  1     1   1   1     1         1   
  1     1   1   1     1         1   
  1     1   1   1     1         1   
  1     1   1   1     1         1   
  1 11111 111 112 11111 111111111   
                                    
        1   1         1             
        1   1         1             
        1   1   1 1   1             
        1   1         1             
        1   1   1 1   1 11111 111   
        1   1   1 1                 
        6 111 111 1         1   1   
                  1         1   1   
                1 1         1   1   
                            1   1   
                1 1 113 11111   1   
                1               1   
                1     1         1   
                1     1         1   
                1     1         1   
                1     1         1   
                1 11111 117 11111   
                                    
                1         1     1   
                1         1     1   
                1 11111   1     1   
                          1     1   
                1     1   1     1   
                1     1   1     1   
      1 1111111 1     1 111 11111   
                                    
      1       1           1         
      1       1           1         
      1       1 11111111111 1111111 
      1                             
      1       1                   1 
      1       1                   1 
      5 1111111                   1 
                                  1 
              1 11111111  111111111 
                                    
                                    
                                    
                                    
                                    
                                    
                                    
                                    
                                    
*