Textures/garden3.bmp
3 0
9 123
0
  30700007002     
  1 1    1  1     
  1 1  A 1B 1     
  80:002 1  1H    
  1 1  80:009     
  1 1  1 1  1G    
  406009 1  1     
       1 1  1F    
  C 300:0:009     
    1  1 1  1E    
    1\ 1 1  1     
    4709 1  8002  
     1 809H 1  1  
     1 1 1  1\ 1  
  A  1 1 8006009  
30070:0609     1  
1  1 1   1G    1  
80060:000600700602
1    1      1    1
1S U 1C   B 1S U 1
1    80007009    1
1M O 1   1  1M O 1
40000:0009X 800005
     1   1  1     
     1   1V 1     
     8000:009     
     1   1  1     
 3000:0009H 8002  
 1   1   1  1  1  
 1 B 1C  1  1E 1  
 1   1   1  1  1  
 8000:000:00:009  
 1   1   1  1  1  
 1 G 1 F 1\ 1\ 1  
 80006000:006705  
 1       1   1    
 1   I   1 K 1    
 1       1   1    
 40070000:00060002
    1    1       1
    1 D  1B C  B 1
    1    1       1
    80070600007009
    1  1      1  1
30009E 1      1F 1
1   1  1Y Z [ 1  1
8000:00:000000:009
1   1  1      1  1
1   1C 1Y Z [ 1D 1
80705  1      8009
1 1    47007005  1
1 1     1  1   \ 1
80:00700:00:007005
1 1  1  1  1  1   
40600:00:00:009   
     1  1  1  1   
     1G 1A 1H 1   
     1  1  1  1   
    36006076075   
    1     1  1    
    1C  B 1D 1    
    1     1  1    
  30:00700:00:02  
  1 1  1  1  1 1  
  1 1F 1  1E 1 1  
  809  4005  809  
  1 1        1 1  
  40:00070070:05  
    1   1  1 1    
    1 B 1C 1 1    
    1   1  1 1    
    8000:00:09    
    1   1  1 1    
    1 K 1  1 1    
30009   800609    
1   1   1    1    
1J  1   1Y [ 1    
40706070670009    
  1   1  1   1    
  1   1  1   1    
  1   1H 1 G 1    
  8000:00:0005    
  1   1  1        
  1   1  1 I      
  80706009        
  1 1    1        
  1 1Y [ 1        
  8060070600700002
  1    1    1    1
  4000060070607009
          1   1  1
          1   1J 1
          80706009
          1 1    1
          1 1Y [ 1
          80:00009
          1 1    1
          1 1Y [ 1
    30070060:00705
    1  1    1  1  
    1C 1B D 1\ 1  
 300600:00006009  
 1     1       1  
 1     1     F 1  
 800700607000705  
 1  1    1   1    
 1\ 1    1   1    
 400:0000:0009    
    1    1   1    
    1 E  1 G 1    
    80000:0009    
    1    1   1    
    1Y [ 1   1    
    80000:000:002 
    1    1   1  1 
    1 J  1 I 1  1 
    407006000:005 
      1      1    
      1Y Z [ 1    
      400;0005    
         1        
         1        
         1        
         1        
*
    1 111 111111111 11111           
                                    
    1   1         1     1           
    1   1         1     1           
    1   1         1     1           
    1   1         1     1           
    1 111 11111   1     1           
                  1     1           
    1   1     1 111 11111           
    1   1                           
    1   1     1   1     1           
    1   1     1   1     1           
    1 111111111   1     1           
              4   1     2           
              1   1     1           
              1   1     1           
        1 11111 111 11111           
                                    
        1     1   1     1           
        1     1   1     1           
        1     1   1     1           
        1     1   1     1           
        1 1 111   1     1 11111     
                  1                 
          1   1 111     1     1     
          1             1     1     
          1   1   1     1     1     
          1   1   1     1     1     
          1   1   1 11111 11111     
          1   1                     
1 11111 116 111 111           1     
                              1     
1     1   1       1           1     
1     1   1       1           1     
1 11111 111 111111> 11111 11111 111 
                                    
1         1             1         1 
1         1             1         1 
1         1             1         1 
1         1             1         4 
1         1 1111111 11111         1 
1                                 1 
3         1       1     1         1 
1         1       1     1         1 
1 111111111 1111111     1 111111111 
                                    
          1       1     1           
          1       1     1           
          1       1     1           
          1       1     1           
          1 1111111 11111           
                                    
          1       1     1           
          1       1     1           
  1 1111111 111111:     1 11111     
                                    
  1       1       1     1     1     
  1       1       1     1     1     
  1       1       1     1     1     
  1       1       1     1     1     
  1       1       5     1     1     
  1       1       1     1     1     
  1 1111111 1111111 11111 11111     
                                    
  1       1       1     1     1     
  1       1       1     1     1     
  1       1       1     1     1     
  1       1       1     1     1     
  = 1111111 1111111 11111 1 111     
                                    
  1               1       1         
  1               1       1         
  1               1       1         
  1               1       1         
  1               1       1         
  1               1       1         
  1 11111 111111113 1111111 1111111 
                                    
        1         1               1 
        1         1               1 
        1         1               1 
        1         1               1 
        1         1               1 
        1         1               1 
        1 11111 111 111111111 11111 
                                    
        1     1             1     1 
        1     1             1     1 
1 1111111     1             1     1 
              1             1     1 
1       1     1             1     1 
1       1     1             1     1 
5 1111111 11111 1111118111111 11111 
                                    
1       1     1             1     1 
1       1     1             1     1 
1       1     1             1     1 
1       1     1             1     1 
1 111 111     1             1 11111 
              1                     
1   1         > 1 11111 11111     1 
1   1                             1 
1   1           1     1           6 
1   1           1     1           1 
2 111 11111 11111 11111 11111 11111 
                                    
1   1     1     1     1     1       
1   1     1     1     1     1       
1 111 11111 11111 11111 11112       
                                    
          1     1     1     1       
          1     1     1     1       
          1     1     1     1       
          1     1     1     1       
          1     1     1     1       
          1     1     1     1       
        1 1 11113 111 1 111 1       
                                    
        1           1     1         
        1           1     1         
        1           1     1         
        1           1     1         
        1           1     1         
        1           1     1         
    1 111 11111 11111 11111 111     
                                    
    1   1     1     1     1   1     
    1   1     1     1     1   1     
    1   1     1     1     1   1     
    1   1     1     1     1   1     
    1 111     4 11713     1 111     
                                    
    1   1                 1   1     
    1   1                 1   1     
    1 111 1111111 11111 111 111     
                                    
        1       1     1   1         
        1       1     1   1         
        1       1     1   1         
        1       1     1   1         
        1       1     1   1         
        1       1     1   1         
        1 1111112 11111 111         
                                    
        1       1     1   1         
        1       1     1   1         
        1       1     1   1         
        1       1     1   1         
1 1111111       1 11111 111         
                                    
1       1       1         1         
1       1       1         1         
1       1       1         1         
1       1       1         1         
1 111 111 111 111 1 1111111         
                                    
    1       1     1       1         
    1       1     1       1         
    1       1     1       1         
    1       1     1       1         
    1       1     1       1         
    1       1     1       1         
    : 1111111 11111 1111116         
                                    
    1       1     1                 
    1       1     1                 
    1       1     1                 
    1       1     1                 
    1 111 111 11111                 
                                    
    1   1         1                 
    1   1         1                 
    1   1         1                 
    1   1         1                 
    1 111 11111 111 11111 111111111 
                                    
    1         1         1         1 
    1         1         1         1 
    1 111111111 11111 111 111 11111 
                                    
                    1       1     1 
                    1       1     1 
                    4       1     1 
                    1       1     1 
                    1 111 112 11111 
                                    
                    1   1         1 
                    1   1         1 
                    1   1         1 
                    1   1         1 
                    1 111 111111111 
                                    
                    1   1         1 
                    1   1         1 
                    1   1         1 
                    1   1         1 
        1 11111 11111 111 11111 111 
                                    
        3     1         1     1     
        1     1         1     1     
        1     1         1     1     
        1     1         1     1     
  1 11111 11111 111111111 11111     
                                    
  1           1               6     
  1           1               1     
  1           1               1     
  1           1               1     
  1 11111 11111 111 1111111 11:     
                                    
  1     1         1       1         
  1     1         1       1         
  1     1         1       1         
  1     1         1       1         
  1 11111 111111111 1111111         
                                    
        1         1       1         
        1         1       1         
        1         1       1         
        1         1       1         
        8 111111111 1111111         
                                    
        1         1       1         
        1         1       1         
        1         1       1         
        1         1       1         
        1 11111111: 1111111 11111   
                                    
        1         1       1     1   
        1         1       1     1   
        1         1       1     1   
        1         1       1     1   
        1 111 11111 1111111 11111   
                                    
            1             1         
            1             1         
            1             1         
            1             1         
            1 1111  1111111         
                                    
                                    
                                    
                                    
                                    
                                    
                                    
                                    
                                    
*