Textures/desert2.bmp
7 0
7 117
0
      3002        
   3009  8002     
   1  1  1  1     
   1B 1  1  1     
   1  1  1A 1     
   4706006075     
    1      1      
30009      80002  
1   1      1   1  
80075 D    47009  
1  1        1  1  
8006007007006009  
1     1  1     1  
1     1  1 B   1  
802C  8009   309  
1 80009  80009 1  
1 1   1  1   1 1  
1 80075  47009 1  
1 1  1    1  1 1  
1 1  1    1  1 1  
8060062  3600609  
1     1  1     1  
1     1  1     1  
1     8009     1  
1 D   1  1D    1  
8007009A 8007009  
1  1  1  1  1  1  
8009  1  1  8009  
1  1  1  1B 1  1  
1  4076006705  1  
1    1    1    1  
800709    807009  
1  1 1    1 1  1  
1  809D   809  1  
1  1 1    1 1  1  
800675 C  476009  
1   1      1   1  
47075      47075  
 1 1     A  1 1   
 1 1 B      1 1   
 80670700707609   
 1  1 1  1 1  1   
 1  1 1  1 1  1   
362 1 1B 1 1 362  
1 80609  80609 1  
475   1  1   475  
 1    1  1C   1   
 47070:00:07075   
  1 1 1  1 1 1    
30609 1  1 80602  
1   40:00:05   1  
802   1  1   309  
1 1   1  1   1 1  
1 80705  4070:09  
1 1 1      1 1 1  
1 1 1      1 1 1  
47609      80675  
 1  1 D    1  1   
 1  1      1B 1   
 400:02  30:005   
    1 8009 1      
 300609  806002   
 1    1  1    1   
 1 B  1A 1    1   
 402  1  1  305   
   8009  8009     
   1  1  1  1C    
3009  1  1  8002  
1  1  8009  1  1  
8005  1  1  4009  
1   309  802   1  
1 A 1 1  1 1   1  
4700:05  40:0075  
 1  1      1  1   
 1  1  C   1  1   
 1  1      1  1   
3600:002300:0062  
1   1  11  1   1  
80009  11  80009  
1   80754709   1  
1 B 1 1  1 1   1  
40705 8009 40705  
  1   1  1   1    
  802 1A 1 309    
  1 1 1  1 1 1    
  476760067675    
   1 1    1 1     
   1 1    1 1     
   809    809     
   1 1D   1 1     
   1 800009 1     
   1 1    1 1     
   40:0770:05     
     1 11 1       
     805409       
  3009    8002    
  1  1    1  1    
  1  1    1A 1    
  4709 B  8075    
   1 1    1 1     
300:0:0000:0:002  
1  1 1    1 1  1  
1C 1 1  C 1 1  1  
8009 470075 8009  
1  1  1  1  1  1  
1  1  1  1  1  1  
8006009  8006009  
1     1  1     1  
1 B   1  1     1  
4000075  4700005  
     1    1       
     1    1 C     
 A   1    1       
     1D   1       
     40;005       
       1          
       1          
       1          
*
            1 11111                 
                                    
      1 11111     1 11111           
                                    
      1     1     1     1           
      1     1     1     1           
      1     1     1     1           
      1     1     1     1           
      1     1     1     1           
      1     1     1     1           
      1 1 111 11111 111 1           
                                    
        1             1             
        1             1             
1 1111111             1 1111111     
                                    
1       1             1       1     
1       1             1       1     
1 11111 6             6 1 11111     
                                    
1     1                 1     1     
1     1                 1     1     
1 11111 11111 11111 11111 11111     
                                    
1           1     1           1     
1           1     1           1     
1           1     1           1     
1           1     1           1     
4 111       1 11111       1 114     
                                    
1   1 1111111     1 1111111   1     
1                             1     
1   1       1     1       1   1     
1   1       1     1       1   1     
1   2 11111 1     1 1 11112   1     
1                             1     
1   1     1         1     1   1     
1   1     1         1     1   1     
1   1     1         1     1   1     
1   1     1         1     1   1     
1 116 11111 8     7 1 11116 111     
                                    
1           1     1           1     
1           1     1           1     
1           1     1           1     
1           1     1           1     
1           1 11111           1     
1                             1     
1           1     1           1     
1           1     1           1     
1 11116 11111     1 11116 11111     
                                    
1     1     1     1     1     1     
1     1     1     1     1     1     
1 11111     1     1     1 11111     
            1     1                 
1     1     1     1     1     1     
1     1     1     1     1     1     
1     1 111 1 11111 1 111     1     
1                             1     
1         1         1         1     
1         1         1         1     
1 11111 111         1 111 11111     
                                    
1     1   1         1   1     1     
1     1   1         1   1     1     
1     1 111         1 111     1     
1                             1     
1     1   1         1   1     1     
1     1   1         1   1     1     
1 11111 5 1         1 5 1 11111     
                                    
1       1             1       1     
1       1             1       1     
: 1 111 1             1 1 111 :     
                                    
  1   1                 1   1       
  1   1                 1   1       
  1   1                 1   1       
  1   1                 1   1       
  1 111 1 111 11111 111 1 111       
                                    
  1     1   1     1   1     1       
  1     1   1     1   1     1       
  1     1   1     1   1     1       
  1     1   1     1   1     1       
> 1 7   1   1     1   1   = 1 8     
        1   1     1   1             
1   1 111 111     1 111 111   1     
1                             1     
4 1 6       1     1       6 1 4     
            1     1                 
  1         1     1         1       
  1         1     1         1       
  1 1 111 111 11111 111 111 1       
                                    
    1   1   1     1   1   1         
    1   1   1     1   1   1         
3 111 111   1     1   1 111 113     
            1     1                 
1       1 111 11111 111       1     
1                             1     
1 111       1     1       1 111     
            1     1                 
1   1       1     1       1   1     
1   1       1     1       1   1     
1   5 111 111     1 111 115 111     
1                                   
1   1   1             1   1   1     
1   1   1             1   1   1     
1   1   1             1   1   1     
1   1   1             1   1   1     
1 1 1 111             1 111 1 1     
                                    
  1     1             1     1       
  1     1             1     1       
  1     1             1     1       
  1     1             1     1       
  1 11111 111     1 111 11111       
                                    
        1   1 11111   1             
        1             1             
  4 11111 111     1 111 11114       
                                    
  1         1     1         1       
  1         1     1         1       
  1         1     1         1       
  1         1     1         1       
  1 111     1     1     1 111       
            1     1                 
      1 11112     2 11111           
                                    
      1     1     1     1           
      1     1     1     1           
3 11111     1     1     1 11113     
            1     1                 
1     1     1 11111     1     1     
1     1                 1     1     
1 11111     1     1     1 11111     
            1     1                 
1       1 111     1 111       1     
1                             1     
1       1   1     1   1       1     
1       1   1     1   1       1     
1 1 11111 111     1 111 11111 1     
                                    
  1     1             1     1       
  1     1             1     1       
  1     1             1     1       
  1     1             1     1       
  1     1             1     1       
  1     1             1     1       
7 1 11114 11111 1 11114 11111 7     
                                    
1       1     1 1     1       1     
1       1     1 1     1       1     
1 1111111     1 1     1 1111111     
              1 1                   
1       6 111 1 1 1 116       1     
1                             1     
1       1   1     1   1       1     
1       1   1     1   1       1     
1 11> 111   1 11111   1 11= 111     
                                    
    1       1     1       1         
    1       1     1       1         
    1 111   1     1   1 111         
            1     1                 
    1   1   1     1   1   1         
    1   1   1     1   1   1         
    1 1 1 5 1 11111 4 1 2 1         
                                    
      1   1         1   1           
      1   1         1   1           
      1   1         1   1           
      1   1         1   1           
      1 111         1 111           
                                    
      1   1         1   1           
      1   1         1   1           
      1   4 111181115   1           
      1                 1           
      1   1         1   1           
      1   1         1   1           
      2 111 111 1 111 111           
                                    
          1   1 1   1               
          1   1 1   1               
          1 111 1 111               
                                    
    4 11111         1 11114         
                                    
    1     1         1     1         
    1     1         1     1         
    1     1         1     1         
    1     1         1     1         
    5 1 111         1 111 5         
                                    
      1   1         1   1           
      1   1         1   1           
1 11111 111 111111111 111 11111     
                                    
1     1   1         1   1     1     
1     1   1         1   1     1     
1     1   1         1   1     1     
1     1   1         1   1     1     
1 11111   1 1 11111 1   1 11111     
                                    
1     1     1     1     1     1     
1     1     1     1     1     1     
1     1     1     1     1     1     
1     1     1     1     1     1     
1 11111 11111     1 11111 11111     
                                    
1           1     1           1     
1           1     1           1     
1           1     1           1     
1           1     1           1     
6 111111111 1     1 1 111111116     
                                    
          1         1               
          1         1               
          1         1               
          1         1               
          1         1               
          1         1               
          1         1               
          1         1               
          1 11  11111               
                                    
                                    
                                    
                                    
                                    
                                    
                                    
*