Textures/town1.bmp
11 0
8 165
0
  300000000702    
  1        1 1    
  1        1 1    
  1B    C  1 8002 
  807000000:05  1 
  1 1      1  G 1 
  1 1G H G 1    1 
  1 47000075    1 
  1  1    1     1 
  1  1 F  1  D  1 
  400:00706007005 
     1  1    1    
     1F 1  G 1    
     1  1    1    
30000600:07006002 
1       1 1     1 
1H    G 1 1     1 
800002  1 1 I   1 
1    1  1 1     1 
1    1  1 8000709 
80000600:05   1 1 
1       1   F 1 1 
1       1G    1 1 
470070005     805 
 1  1         1   
 1F 1         1   
 1  1 J  L  E 1   
 1  40070000709   
 1     1    1 1   
 1     1 H  1 1   
 1B    1    1 1   
 400700:0000609   
    1  1      1   
    1  1  G   1   
    1  40700006002
 K  1    1       1
    1    1  E    1
    80000:00007075
    1    1    1 1 
  E 1    1    1 1 
    1 I  800005 1 
    1    1      1 
    40700600002 1 
      1       1 1 
      1G    G 809 
      400070005 1 
 A        1     1 
          1     1 
30000700006070075 
1    1      1  1  
1 H  1F G F 1  1  
1    1      1  1  
80000:0007005  1  
1    1   1     1  
1 F  1 E 8000009  
1    1   1     1  
800006000:007005  
1        1  1     
1G  F  G 1  1     
400070070600600002
    1  1         1
    1  1H      H 1
    1  1   D     1
    1  1         1
3070:0060000070709
1 1 1        1 1 1
1 1 4000070005 1 1
1 1      1     1 1
1 1    F 1  F  1 1
1 4000700:007005 1
1     1  1  1    1
1     1G 1G 1    1
407000600:00600705
  1      1     1  
  1  H   1  F  1  
306707000600707602
1  1 1      1 1  1
1E 1 1  G   1 1  1
4075 47000705 4705
  1   1   1    1  
  1   1   1    1  
  1   1 E 1    1  
  400060;0600005  
        1         
        1         
        1         
   A    1 A       
*
    1 11111111111111111 111         
                                    
    1                 1   1         
    1                 1   1         
    1                 1   1         
    1                 1   1         
    1                 1   1 11111   
    1                 1             
    1 111 1111111111111 111     1   
                                1   
    1   1             1         1   
    1   1             1         1   
    1   1             1         1   
    1   1             1         1   
    1   1 1 111111111 1         1   
    1                           1   
    1     1         1           1   
    1     1         1           1   
    1     1         1           1   
    1     1         1           1   
    1 11111 11111 11; 11111 11111   
                                    
          1     1         1         
          1     1         1         
          1     1         1         
          1     1         1         
          1     1         1         
          1     1         1         
1 111111114 11111 111 11111 11111   
                                    
1               1   1           1   
1               1   1           1   
1               1   1           1   
1               1   1           1   
1 111111111     1   1           1   
                1   1           1   
1         1     1   1           1   
1         1     1   1           1   
1         1     1   1 1111111 111   
1         1     1                   
1 111111111 11111 111       1   1   
                            1   1   
1               1           1   1   
1               1           1   1   
1               1           1   1   
1               1           1   1   
1 1 11112 1111111           5 111   
                                    
  1     1                   1       
  1     1                   1       
  1     1                   1       
  1     1                   1       
  1     1                   1       
  1     1                   1       
  1     1 11111 111111111 111       
  1                                 
  1           1         1   1       
  1           1         1   1       
  1           1         1   1       
  1           1         1   1       
  1           1         1   1       
  1           1         1   1       
  3 11111 11111 111111111 111       
                                    
        1     1             1       
        1     1             1       
        1     1             1       
        1     1             1       
        1     1 111 111111111 11111 
        1                           
        1         1               1 
        1         1               1 
        1         1               1 
        1         1               1 
        5 111111111 111111111 11> 1 
                                    
        1         1         1   1   
        1         1         1   1   
        1         1         1   1   
        1         1         1   1   
        1         1 111111111   1   
        1                       1   
        1         1             1   
        1         1             1   
        1 111 1111B 111111111   1   
                                1   
            1               1   1   
            1               1   1   
            1               1 111   
            1                       
            1 1111111 1111111   1   
                                1   
                    1           1   
                    1           1   
                    1           1   
                    1           1   
1 111111111 111111116 111 11111 1   
                                    
1         1             1     1     
1         1             1     1     
1         1             1     1     
1         1             1     1     
1         1             1     1     
1         1             1     1     
1 111111111 1111111 11111     1     
                              1     
1         1       1           1     
1         1       1           1     
1         1       1 11111111114     
1         1                         
1         1       1           1     
1         1       1           1     
1 111111113 1111111 11111 11111     
                                    
1                 1     1           
1                 1     1           
1                 1     1           
1                 1     1           
1 1111111 11111 111 11111 111111111 
                                    
        1     1                   1 
        1     1                   1 
        1     1                   1 
        1     1                   1 
        1     1                   1 
        1     1                   1 
        1     1                   1 
        1     1                   1 
1 111 11; 11111 11111111111 111 111 
                                    
1   1   1                 1   1   1 
1   1   1                 1   1   1 
1   1   1 111111111 1111111   1   1 
1   1                         1   1 
1   1             1           1   1 
1   1             1           1   1 
1   1             1           1   1 
1   1             1           1   1 
1   4 1111111 11111 11111 11116   1 
1                                 1 
1           1     1     1         1 
1           1     1     1         1 
1           1     1     1         1 
1           1     1     1         1 
3 111 1111111 11111 11111 11111 115 
                                    
    1             1           1     
    1             1           1     
    1             1           1     
    1             1           1     
1 111 1 111 1111111 11111 111 1 111 
                                    
1     1   1             1   1     1 
1     1   1             1   1     1 
1     1   1             1   1     1 
1     1   1             1   1     1 
1 111 1   1 1 1111111 111   1 1 111 
                                    
    1       1       1         1     
    1       1       1         1     
    1       1       1         1     
    1       1       1         1     
    1       1       1         1     
    1       1       1         1     
    1 1111111 11  111 111111111     
                                    
                                    
                                    
                                    
                                    
                                    
                                    
                                    
                                    
*