Textures/classic2.bmp
4 0
12 70
0
    3002          
    1  1          
    1  8002       
    8009  1       
    1  1  1       
    1  800:002    
    8009  1  1    
    1  1  1  1    
    8006076775    
    1    1 11     
    1    1 18002  
    800709 11  1  
    1  1 1 11  1  
    800:060:6075  
    1  1   1  1   
    1  1   1  1   
    800:000:009   
    40062  1  1   
        8009  1   
        1  1  1   
        800:009   
        1  1  1   
        1  1  1   
      309  8009   
      1 1  1  1   
      1 1  1  1   
30007060:00:006002
1   1   1  8007009
807060009  1  1  1
1 1     1309  1  1
1 1     11 4006709
8067007069     1 1
1  1  1  1     809
8009  1  1     1 1
1  1  1  1     1 1
1  870:00:000709 1
40091 1  1   1 809
   49 1  1   1 1 1
    1 1 360009 1 1
    80:05    80:09
    1 1      1 1 1
    1 1      1 1 1
 300:0:07007067609
 1  1 1 1  1  1  1
 1  1 1 1  1  8075
 8009 80:009  1 1 
 1  1 1 1  1  809 
 1  1 1 1  1  1 1 
 400:0:0670670609 
    1 1  1  1   1 
    1 1  1  1   1 
    1 1  80060709 
    406079    1 1 
        11    1 1 
        860007609 
        1    1  1 
        1    1  1 
        80070:009 
        1  1 1  1 
        8009 8009 
        1  1 1  1 
       35  476075 
    3009    1  1  
    1  80070607602
    1  1  1   1  1
    4009  1   1  1
       40060;06005
            1     
            1     
            1     
            1     
*
        1 11111                     
                                    
        1     1                     
        1     1                     
        1     1 11111               
        1                           
        1 11111     1               
                    1               
        1     1     1               
        1     1     1               
        1     1 11111 11111         
        1                           
        1 11111     1     1         
                    1     1         
        1     1     1     1         
        1     1     1     1         
        1 11111 111 1 1 1 1         
                                    
        1         1   1 1           
        1         1   1 1           
        1         1   1 1 11111     
        1         1   1             
        1 11111 111   3 1     1     
                      1 1     1     
        1     1   1   1 1     1     
        1     1   1   1 1     1     
        1 11111 111 111 1 111 2     
                                    
        1     1       1     1       
        1     1       1     1       
        1     1       1     1       
        1     1       1     1       
        1 11111 1111115 11111       
                                    
        1 11111 1     1     1       
                      1     1       
                1 11111     1       
                            1       
                1     1     1       
                1     1     1       
                1 11111 11111       
                                    
                1     1     1       
                1     1     1       
                1     1     1       
                6     1     1       
            1 111     1 11111       
                                    
            1   1     1     1       
            1   1     1     1       
            1   1     1     1       
            1   1     1     1       
1 1111111 111 111 11111 1111> 11111 
                                    
1       1       1     1 11111 11111 
1       1       1                   
1 111 111 1111112     1     1     1 
                      1     1     1 
1   1           1 1 111     1     1 
1   1           1           1     1 
1   1           1 1   1 11111 1 111 
1   1           1 1                 
1 111 1 1111: 111 1           1   1 
                              1   1 
1     1     1     1           5 111 
1     1     1     1                 
1 11111     1     1           1   1 
            1     1           1   1 
1     1     1     1           1   1 
1     1     1     1           1   1 
1     1 1 111 11111 1111111 111   1 
1                                 1 
1 11111 1   1     1       1   1 111 
        1   1     1       1         
      1 1   1     1       1   1   1 
            1     1       1   1   1 
        1   1   7 1 1111111   1   1 
        1   1                 1   1 
        1 114 111         1 111 111 
                                    
        1   1             1   1   1 
        1   1             1   1   1 
        1   1             1   1   1 
        1   1             1   1   1 
  1 11111 111 111 11111 111 5 1 111 
                                    
  1     1   1   1     1     1     1 
  1     1   1   1     1     1     1 
  1     1   1   1     1     1 111 1 
  1     1   1   1     1             
  1 11111   1 111 11111     1   1   
                            1   1   
  1     1   1   1     1     1 111   
  1     1   1   1     1             
  1     1   1   1     1     1   1   
  1     1   1   1     1     1   1   
  1 11111 111 112 1 111 1 111 111   
                                    
        1   1     1     1       1   
        1   1     1     1       1   
        1   1     1     1       1   
        1   1     1     1       1   
        1   1     1 11111 111 111   
        1   1                       
        6 111 111 1         1   1   
                            1   1   
                1 1         1   1   
                1 1         1   1   
                1 1 1131111 1 111   
                                    
                1         1     1   
                1         1     1   
                1         1     1   
                1         1     1   
                1 11111 117 11111   
                                    
                1     1   1     1   
                1     1   1     1   
                1 11111   1 11111   
                                    
                1     1   1     1   
                1     1   1     1   
              1 1     1 1 1 111 1   
                                    
        1 11111         1     1     
                        1     1     
        1     1 11111 111 111 1 111 
        1                           
        1     1     1       1     1 
        1     1     1       1     1 
        5 11111     1       1     1 
                    1       1     1 
              1 11111 11  111 11111 
                                    
                                    
                                    
                                    
                                    
                                    
                                    
                                    
                                    
*