Textures/garden1.bmp
8 0
12 118
0
   3070070002     
   1 1 362  1F    
   1 1 1 1  1     
   1 1 1 1  1G    
   80:05 4009     
   1 1      1H    
   1 8002 A 1     
   1 1  1   1E    
 3060600:0006002  
 1      1      1  
 8007000:007000:02
 1  1   1  1   1 1
 1  4000600:000:09
 8000000000:0009 1
 1  3002   1   1 1
 1  1  1 D 1C  1 1
 1F 1\ 1   1   1 1
 1  80060706000609
36709    1       1
1 1 1Y [ 1E G H  1
1 1 80000:00000009
1 1 1    1       1
1 1 40000:07007009
1 1      1 1  1  1
1 80000005 1J 1B 1
1 1        1  1  1
406000700706076075
      1  1   1  1 
   300600:000:005 
   1     1   802  
   8000009 K 1 1  
 G 1     1   1 1  
   400700:000:75  
      1  1   11   
      1\ 1 C 11   
 E 300607607051   
   1    1  1  1   
   40070:00:005   
      1 1  1      
   30060:076002   
   1    1 1   1   
   1F H 1 1 A 1   
   4070060:0076702
     1    1  1 1 1
     800009  1 1 1
     1    1G 1 1 1
     1C D 4075 1 1
     1      1  1 1
     8000000:005 1
300009      1    1
1    4070000670005
1D     1     1    
80007009     8002 
1   1  8000009  1 
1   1A 1     1B 1 
1   1  1Y [  1  1 
47005  400700:075 
 1   K    1  1 1  
 4070700009  1 1  
   1 1    1  1 1  
   1 800076005 1  
   1 1   1     1  
   1 1 306007005  
  35 1 1    1     
  1  1 1 B  1     
  80060:00009 G   
  1    1    1     
  80000:00006002  
  1    1       1  
  1F 30600007009  
  1  1      1  1  
  1E 1C D C 1J 1  
  8009      4009  
  1  1  B      1  
  1  80000000009  
  1  1         1  
  800:0000700009  
  1  1    1    1  
  1  1Y [ 1Y [ 1  
  1X 40000:00009  
  1       1    1  
  1V      1H E 1  
  80000700:00009  
  1    1  1    1  
  1    1C 1    1  
  1S U 800:00705  
  1    1  1  1    
  1M O 1D 1C 1B   
  40000:006075    
       1    1     
   E G 1Y [ 1     
       80070600702
   F H 1  1    1 1
       1\ 1 J  1 1
    300:0060070609
    1  1     1   1
    1A 1C  D 1 C 1
    1  400700:0009
  309     1  1   1
  1 4070009  80009
  1   1   8005   1
  80009B  1      1
  1   8000:0000005
  1   1   1       
  40709   800002  
    1 40009    1  
    1 30009    1  
    1 1   1    1  
    805   1 3009  
    1   D 1 1  1  
    1     1 1  1  
    400700:06009  
       1  1    1  
       1\ 1 J  1  
       40060;005  
            1     
            1     
            1     
            1     
*
      1 111 11111 1111111           
                                    
      1   1   1 1 1     1           
      1   1             1           
      1   1   1   1     1           
      1   1   1   1     1           
      1   1   1   1     1           
      1   1   1   1     1           
      1 111 111   1 11111           
                                    
      1   1             1           
      1   1             1           
      1   1 11111       1           
      1                 1           
      1   1     1       1           
      1   1     1       1           
  1 111 111 11111 1111111 11111     
                                    
  1             1             1     
  1             1             1     
  1 11112 1111111 11111 1111111 111 
                                    
  1     1       1     1       1   1 
  1     1       1     1       1   1 
  1     1 1111111 11111 1111111 111 
  1                                 
  1 1111111111111111111 1111111   1 
                                  1 
  1     1 11111       1       1   1 
  1                   1       1   1 
  1     1     1       1       1   1 
  1     1     1       1       1   1 
  1     1     1       1       1   1 
  1     1     1       1       1   1 
  1     1 11111 111 115 1111111 111 
  1                                 
1 1 1 111         1               1 
                  1               1 
1   1   1         1               1 
1   1   1         1               1 
1   1   1 111111111 111111111111111 
1   1                               
1   1   1         1               1 
1   1   1         1               1 
1   1   6 111111111 111 11111 11111 
1   1                               
1   1             1   1     1     1 
1   1             1   1     1     1 
1   : 1111111111111   1     1     1 
1                     1     1     1 
1   1                 1     1     1 
1   1                 1     1     1 
< 11111111111 11111 111 111 1 111 1 
                                    
            1     1       1     1   
            1     1       1     1   
      1 11114 11111 1111111 11111   
                                    
      1           1       1 111     
      1           1                 
      1 11111111111       1   1     
                          1   1     
      1           1       1   1     
      1           1       1   1     
      1 11111 11111 1111111 1 1     
                                    
            1     1       1 1       
            1     1       1 1       
            1     1       1 1       
            1     1       1 1       
      1 11111 111 1 113 111 1       
                            1       
      1         1     1     1       
      1         1     1     1       
      1 11111 111 11111 11111       
                                    
            1   1     1             
            1   1     1             
      1 11111 111 111 1 11111       
                                    
      1         1   1       1       
      1         1   1       1       
      1         1   1       1       
      1         1   1       1       
      1 112 11111 111 11111 1 = 111 
                                    
          1         1     1   1   1 
          1         1     1   1   1 
          1 111111111     1   1   1 
                          1   1   1 
          1         1     1   1   1 
          1         1     1   1   1 
          1         1 111 1   1   1 
          1                   1   1 
          1             1     1   1 
          1             1     1   1 
          1 1111111111111 11111   1 
                                  1 
1 111111111             1         1 
                        1         1 
1         1 111 111111111 1 1111118 
1                                   
1             1           1         
1             1           1         
1 1111111 11111           1 11111   
                                    
1       1     1 11111111111     1   
1       1                       1   
1       1     1           1     1   
1       1     1           1     1   
1       1     1           1     1   
1       1     1           1     1   
1 7 11111     1 11111 11111 111 1   
                                    
  1                 1     1   1     
  1                 1     1   1     
  1 111 111 111111111     1   1     
                          1   1     
      1   1         1     1   1     
      1   1         1     1   1     
      1   1 1111111 1 11111   1     
      1                       1     
      1   1       1           1     
      1   1       1           1     
      1   1   1 111 11111 11115     
      1   1                         
    1 1   1   1         1           
          1   1         1           
    1     1   1         1           
    1     1   1         1           
    1 11111 111 111111111           
                                    
    1         1         1           
    1         1         1           
    1 111111111 111111111 11111     
                                    
    1         1               1     
    1         1               1     
    1     1 11= 111111111 11113     
    1                               
    1     1             1     1     
    1     1             1     1     
    1     1             1     1     
    1     1             1     1     
    1 11111             1 11111     
                                    
    1     1                   1     
    1     1                   1     
    1     1 1111111111111111111     
    1                               
    1     1                   1     
    1     1                   1     
    1 11111 111111111 111111111     
                                    
    1     1         1         1     
    1     1         1         1     
    1     1         1         1     
    1     1         1         1     
    1     1 111111111 111111116     
    1                               
    1               1         1     
    1               1         1     
    1               1         1     
    1               1         1     
    : 111111111 11111 111111111     
                                    
    1         1     1         1     
    1         1     1         1     
    1         1     1         1     
    1         1     1         1     
    1         1 11111 11111 111     
    1                               
    1         1     1     1         
    1         1     1     1         
    1         1     1     1         
    1         1     1     1         
    1 111111111 11111 111 1         
                                    
              1         1           
              1         1           
              1         1           
              1         1           
              1 11111 114 11111 111 
                                    
              1     1         1   1 
              1     1         1   1 
              1     1         1   1 
              1     1         1   1 
        1 11111 11111 11111 111 111 
                                    
        1     1           1       1 
        1     1           1       1 
        1     1           1       1 
        1     1           1       1 
        1     1 11112 11111 1111111 
        1                           
    1 111           1     1       1 
                    1     1       1 
    1   1 111 1111111     1 1111111 
    1                               
    1       1       1 11111       1 
    1       1                     1 
    1 1111111       1             1 
                    1             1 
    1       1 1111111 1111111111111 
    1                               
    1       1       1               
    1       1       1               
    1 11< 111       1 111111111     
                                    
        1   1 1111111         1     
        1                     1     
        1   1 1111111         1     
        1                     1     
        1   1       1         1     
        1   1       1         1     
        1 111       1   1 11113     
                    1               
        1           1   1     1     
        1           1   1     1     
        1           1   1     1     
        1           1   1     1     
        1 11111 11111 111 11111     
                                    
              1     1         1     
              1     1         1     
              1     1         1     
              1     1         1     
              1 11111 111 11111     
                                    
                                    
                                    
                                    
                                    
                                    
                                    
                                    
                                    
*