Textures/classic5.bmp
8 0
10 111
0
      30702       
      1 1 1       
   300:0:0:002    
   1  1 1 1  1    
   1  1 1 1  1    
   80060:06009    
   1    1    1    
   1    1    1    
   40007670005    
       1 1        
     309 802      
     1 1 1 1      
     805 409      
     1     1      
     1     1      
   30600700602    
   1    1    1    
   1 3006002 1    
   809     809    
   1 4007005 1    
   1    1    1    
   40700:00705    
     1  1  1      
   30600670:002   
   1     806009   
   1     1    1   
   8007009    1   
   407600:00705   
     1   1  1     
     80009  1     
     1   8009     
     1   1  1     
 30076000:0060702 
 1  1    1    1 1 
 1  1  30:02  1 1 
 8009  1 1 1  809 
 1  80060606009 1 
 1  1         1 1 
 1  1         809 
 8009         1 1 
 1  1         1 1 
 1  1         809 
 47060700700709 1 
  1   1  1  1 4062
  1   1  1  1    1
 3607062 1 3607009
 1  1  1 1 1  1  1
 1  1  80:09  1  1
 800:009 1 800:009
 1  1  1 1 1  1  1
 1  1  1 1 1  1  1
 40060067:76006005
        111       
        111       
        111       
  3000706:6070002 
  1   1  1  1   1 
  1 30600:00602 1 
  809    1    809 
  1 1    1    1 1 
  8060700:0070605 
  1   1  1  1     
  1   1  1  1     
  4007600:0062    
     1   1   1    
     1   1   1    
     407060705    
       1   1      
  30070607067002  
  1  1   1  1  1  
  1  1   1  1  1  
  8006700:006709  
  1   1  1   1 1  
  1   1  1   1 1  
  8700670607060602
  11   1   1     1
  113006070:02   1
  8542   1 135 309
  1 35   80542 1 1
  1 42   1  35 1 1
  8235 309  42 809
  1142 1 1  35 1 1
  46760:0670:00:05
    1  1  1 1  1  
    1  1  1 1  1  
    40760760:075  
      1  1  1 1   
      1  1  1 1   
      470670675   
       1  1  1    
       800:009    
       1  1  1    
       1  1  1    
       800:009    
       1  1  1    
       1  1  1    
       800:00:02  
       1  1  1 1  
    300:00:00675  
    1  1  1   1   
    1  1  1   1   
   3607600:007602 
   1  1   1  1  1 
   1  1   1  1  1 
   1  1   1  1  1 
   80767006076709 
   1 1 1    1 1 1 
   1 1 1    1 1 1 
   4060600;060605 
          1       
          1       
          1       
*
            1 111 111               
                                    
            1   1   1               
            1   1   1               
      1 11111 111 111 11111         
                                    
      1     1   1   1     1         
      1     1   1   1     1         
      1     1   1   1     1         
      1     1   1   1     1         
      1 11111 111 111 11111         
                                    
      1         1         1         
      1         1         1         
      1         1         1         
      1         1         1         
      2 1111111 1 1 1111111         
                                    
              1   1                 
              1   1                 
          1 111   1 111             
                                    
          1   1   1   1             
          1   1   1   1             
          1 113   3 111             
                                    
          1           1             
          1           1             
          1           1             
          1           1             
      1 111 11111 11111 111         
                                    
      1         1         1         
      1         1         1         
      1   1 11111 11111   1         
      1                   1         
      1 111           1 111         
                                    
      1   > 11111 11113   1         
      1                   1         
      1         1         1         
      1         1         1         
      4 111 11111 11111 116         
                                    
          1     1     1             
          1     1     1             
      1 111 11111 1 111 11111       
                                    
      1           1 111 11111       
      1                             
      1           1         1       
      1           1         1       
      1 11111 11111         1       
                            1       
      1 111 1 11111 11111 111       
                                    
          1       1     1           
          1       1     1           
          1 1111111     1           
                        1           
          1       1 11111           
          1                         
          1       1     1           
          1       1     1           
  2 11111 1 1111111 11118 111 111   
                                    
  1     1         1         1   1   
  1     1         1         1   1   
  1     1     1 111 111     1   1   
  1     1                   1   1   
  1 11111     1   1   1     1 111   
              1   1   1             
  1     1 11111 111 111 11111   :   
  1                             1   
  1     1                   1   1   
  1     1                   1   1   
  1     1                   1 111   
  1     1                           
  4 11111                   1   1   
                            1   1   
  1     1                   5   1   
  1     1                   1   1   
  1     1                   1 111   
  1     1                           
  1 1 111 111 11111 11111 111   1   
                                1   
    1       1     1     1   1 111 1 
    1       1     1     1           
    1       1     1     1         1 
    1       1     1     1         1 
  7 1 111 111 1   1   1 1 111 11111 
                  1                 
  1     1     1   1   1     1     1 
  1     1     1   1   1     1     1 
  1     1     1 111 111     1     1 
  1     1                   1     1 
  1 11111 11111   1   1 11111 11111 
                  1                 
  1     1     1   1   1     1     1 
  1     1     1   1   1     1     1 
  1     1     1   1   1     1     1 
  1     1     1   1   1     1     1 
  6 11111 11111 1 1 1 1 11111 11113 
                                    
                1 1 1               
                1 1 1               
                1 1 1               
                1 1 1               
                1 1 1               
                1 1 1               
    2 1111111 111 1 1 111 111111:   
                                    
    1       1     1     1       1   
    1       1     1     1       1   
    1   3 111 11111 11111 115   1   
    1                           1   
    1 111         1         1 111   
                  1                 
    1   1         1         1   1   
    1   1         1         1   1   
    1 111 111 11111 11111 111 111   
                                    
    1       1     1     1           
    1       1     1     1           
    1       1     1     1           
    1       1     1     1           
    3 11111 1 11111 11111 1         
                                    
          1       1       1         
          1       1       1         
          1       1       1         
          1       1       1         
          1 111 118 111 111         
                                    
              1       1             
              1       1             
    1 11111 111 111 111 1 11116     
                                    
    1     1       1     1     1     
    1     1       1     1     1     
    1     1       1     1     1     
    1     1       1     1     1     
    1 11111 1 11111 11111 1 111     
                                    
    1       1     1       1   1     
    1       1     1       1   1     
    1       1     1       1   1     
    1       1     1       1   1     
    1 1 11111 1 111 111 111 111 111 
                                    
    1 1       1       1           1 
    1 1       1       1           1 
    1 1 1 11111 111 111 111       1 
    1 1                           1 
    1 1 1 1       1   1 1 1   1 111 
                  1   1             
    1   6 1       1 111 1 3   1   1 
    1                         1   1 
    2   7 1       >     1 :   1   1 
    1             1           1   2 
    1 1 4 1   1 111     1 5   1 111 
                                    
    1 1 1 1   1   1     1 1   1   1 
    1 1       1   1           1   1 
    1 1 1 1 111 111 1 111 11111 111 
                                    
        1     1     1   1     1     
        1     1     1   1     1     
        1     1     1   1     1     
        1     1     1   1     1     
        1 111 1 111 1 111 111 1     
                                    
            1     1     1   1       
            1     1     1   1       
            1     1     1   1       
            1     1     1   1       
            1 1 111 1 111 1 1       
                                    
              1     1     1         
              1     1     1         
              1 11111 11111         
                                    
              1     1     1         
              1     1     1         
              1     1     1         
              1     1     1         
              2 11111 11111         
                                    
              1     1     1         
              1     1     1         
              1     1     1         
              1     1     1         
              1 11111 11111 114     
                                    
              1     1     1   1     
              1     1     1   1     
        5 11111 11111 11111 1 1     
                                    
        1     1     1       1       
        1     1     1       1       
        1     1     1       1       
        1     1     1       1       
      1 1 111 1 11111 11111 1 111   
                                    
      1     1       1     1     1   
      1     1       1     1     1   
      1     1       1     1     1   
      1     1       1     1     1   
      1     1       1     1     1   
      1     1       1     1     1   
      5 111 1 1 11111 111 1 1 113   
                                    
      1   1   1         1   1   1   
      1   1   1         1   1   1   
      1   1   1         1   1   1   
      1   1   1         1   1   1   
      1 111 111 1111  111 111 111   
                                    
                                    
                                    
                                    
                                    
                                    
                                    
*
