Textures/garden2.bmp
8 0
8 126
0
    30000002      
    1      1      
    1B  C  1      
30009      80002  
1   1      1   1  
1   1  D   1   1  
1   80007009   1  
80009   1  80009  
1   1   1  1   1  
1A  1   1  1 I 1  
4700:000:0060075  
 1  1   1     1   
 1  1   1  B  1   
 1E 1 H 1     1   
 800:0006000709   
 1  1       1 1   
 1  1B    C 1 1   
 1  1   D   1 1   
 80060007000675   
 1      1    1    
 1Y Z [ 1Y [ 1    
 4070007670009    
   1   1 1   1    
   1C  1 1 C 1    
 F 40705 40705G   
     1     1      
     1  H  1      
30070:00000:007002
1  1 1     1  1  1
1B 1 1  D  1  1B 1
1  1 8007009  1  1
800609  1  8006009
1    1F 1E 1     1
1    1  1  1     1
40700:00:00:007005
  1  1  1  1  1   
  8006006006009 I 
  1           1   
  8002C  C 3009   
  1  1     1  1   
  1X 1  D  1X 8002
  1  8000009  1  1
  1V 1     1V 1\ 1
  4076007006706005
    1   1   1     
    1   1   1     
   36070607062    
   1  1   1  1    
   1C 1   1B 1    
   8009 A 8009    
   1  1   1  1    
   1J 1   1J 1    
   8009   8009    
   1  1 K 1  1    
   1\ 1   1\ 1    
   40760706705    
     1  1  1      
   H 1\ 1\ 1G     
     800:009      
     1  1  1      
     1B 1B 1      
     1  1  1      
     800:009      
     1  1  1      
     1C 1C 1      
     1  1  1      
     800:009      
     1  1  1      
     1H 1E 1      
 3000600:0060002  
 1      1      1  
 1Y Z [ 1Y Z [ 1  
 800707060707009  
 1  1 1   1 1  1  
 1\ 1 1C  1 1\ 1  
 400:0:000:0:005  
    1 1   1 1     
    80:000:09     
    1 1   1 1     
    1 1F  1 1     
    80:000:09     
    1 1   1 1     
    1 1   1 1     
    1 80009 1     
   3609   80:02   
   1  1   1 1 1   
   1  8000:05 1   
   1  1   1   1   
   8009   80009   
   1  1   1   1   
   1\ 1   1 D 1   
   400:000:0005   
      1   1       
      1 C 1       
   3009   8002    
   1  1   1  1    
   1G 1   1E 1    
   8009J  8009    
   1  1   1  1    
   1F 1   1H 1    
 306006070600602  
 1      1      1  
 1Y Z [ 1Y Z [ 1  
 400700767007005  
    1  1 1  1     
    1B 1 1B 1     
    800606009     
  309       802   
  1 1  C    1 1   
 3609       8062  
 1  1       1  1  
 1H 1D    I 1F 1  
36706000700060762 
1 1     1     1 1 
1 1C  B 1 B C 1 1 
80600700:00700609 
1    1  1  1    1 
80000:00600:00009 
1    1     1    1 
1S U 1     1S U 1 
1    1     1    1 
1M O 1     1M O 1 
40000600;00600005 
        1         
        1         
        1         
        1         
*
        1 1111111111111             
                                    
        1             1             
        1             1             
        1             1             
        1             1             
1 1111111             1 1111111     
                                    
1       1             1       1     
1       1             1       1     
1       1             1       1     
1       1             1       1     
1       1 1111111 11111       1     
1                             1     
1 1111111       1     1 1111111     
                1                   
1       1       1     1       1     
1       1       1     1       1     
1       1       1     1       1     
1       1       1     1       1     
1 1 11111 1111112 11111 11111 1     
                                    
  1     1       1           1       
  1     1       1           1       
  1     1       1           1       
  1     1       1           1       
  1     1       1           1       
  1     1       1           1       
  1 11111 1111111 1111111 111       
                                    
  1     1               1   1       
  1     1               1   1       
  1     1               1   1       
  1     1               1   1       
  1     1               1   1       
  1     1               1   1       
  1 11111 1111111 1111111 1 1       
                                    
  1             1         1         
  1             1         1         
  1             1         1         
  1             1         1         
  1 111 1111111 1 1 1111111         
                                    
      1       1   1       1         
      1       1   1       1         
      1       1   1       1         
      1       1   1       1         
      1 11> 111   1 11< 111         
                                    
          1           1             
          1           1             
          1           1             
          1           1             
1 11111 111 11111111111 11111 11111 
                                    
1     1   1           1     1     1 
1     1   1           1     1     1 
1     1   1           1     1     1 
1     1   1           1     1     1 
1     1   1 11111 11111     1     1 
1     1                     1     1 
1 11111 111     1     1 11111 11111 
                1                   
1         1     1     1           1 
1         1     1     1           1 
1         1     1     1           1 
1         1     1     1           1 
1 118 11111 11111 11111 1111: 11111 
                                    
    1     1     1     1     1       
    1     1     1     1     1       
    1 11111 11111 11111 11111       
                                    
    1                       1       
    1                       1       
    1 11111           1 11111       
                                    
    1     1           1     1       
    1     1           1     1       
    1     1           1     1 11112 
    1     1           1             
    1     1 11111711111     1     1 
    1                       1     1 
    1     1           1     1     1 
    1     1           1     1     1 
    1 113 1 11111 11111 1 116 11111 
                                    
        1       1       1           
        1       1       1           
        1       1       1           
        1       1       1           
      1 1 111 116 111 111 1         
                                    
      1     1       1     1         
      1     1       1     1         
      1     1       1     1         
      1     1       1     1         
      1 11111       1 11111         
                                    
      1     1       1     1         
      1     1       1     1         
      1     1       1     1         
      1     1       1     1         
      1 11114       4 11111         
                                    
      1     1       1     1         
      1     1       1     1         
      1     1       1     1         
      1     1       1     1         
      1 111 1 111 111 1 111         
                                    
          1     1     1             
          1     1     1             
          1     1     1             
          1     1     1             
          2 11111 11111             
                                    
          1     1     1             
          1     1     1             
          1     1     1             
          1     1     1             
          1     1     1             
          1     1     1             
          1 1111< 11113             
                                    
          1     1     1             
          1     1     1             
          1     1     1             
          1     1     1             
          1     1     1             
          1     1     1             
          1 11111 11111             
                                    
          1     1     1             
          1     1     1             
          1     1     1             
          1     1     1             
  1 1111111 11111 11111 1111111     
                                    
  1             1             1     
  1             1             1     
  1             1             1     
  1             1             1     
  6 11111 111 111 111 111 11116     
                                    
  1     1   1       1   1     1     
  1     1   1       1   1     1     
  1     1   1       1   1     1     
  1     1   1       1   1     1     
  1 11111 111 1111111 111 11111     
                                    
        1   1       1   1           
        1   1       1   1           
        1 111 1111111 111           
                                    
        1   1       1   1           
        1   1       1   1           
        1   1       1   1           
        1   1       1   1           
        1 111 1181111 111           
                                    
        1   1       1   1           
        1   1       1   1           
        1   1       1   1           
        1   1       1   1           
        1   1 1111111   1           
        1               1           
      1 1 111       1 111 113       
                                    
      1     1       1   1   1       
      1     1       1   1   1       
      1     1 1111111 111   1       
      1                     1       
      1     1       1       1       
      1     1       1       1       
      4 11111       1 1111112       
                                    
      1     1       1       1       
      1     1       1       1       
      1     1       1       1       
      1     1       1       1       
      3 11111 1111111 1111111       
                                    
            1       1               
            1       1               
            1       1               
            1       1               
      1 11111       1 11111         
                                    
      1     1       1     1         
      1     1       1     1         
      1     1       1     1         
      1     1       1     1         
      1 11111       1 11111         
                                    
      1     1       1     1         
      1     1       1     1         
      1     1       1     1         
      1     1       1     1         
  1 111 11111 111 111 11111 111     
                                    
  1             1             1     
  1             1             1     
  1             1             1     
  1             1             1     
  1 11111 11111 : 1 11111 11111     
                                    
        1     1   1     1           
        1     1   1     1           
        1     1   1     1           
        1     1   1     1           
        1 11111 111 11111           
                                    
    1 111               1 111       
                                    
    1   1               1   1       
    1   1               1   1       
  3 1 111               1 111 4     
                                    
  1     1               1     1     
  1     1               1     1     
  1     1               1     1     
  1     1               1     1     
1 1 1 111 1111111 1111111 111 1 1   
                                    
1   1           1           1   1   
1   1           1           1   1   
1   1           1           1   1   
1   1           1           1   1   
1 111 11111 11111 11111 11111 111   
                                    
1         1     1     1         1   
1         1     1     1         1   
1 111111111 11111 11111 111111111   
                                    
1         1           1         1   
1         1           1         1   
1         1           1         1   
1         1           1         1   
1         1           1         1   
1         1           1         1   
1         1           1         1   
1         1           1         1   
1 111111111 1111  11111 111111111   
                                    
                                    
                                    
                                    
                                    
                                    
                                    
                                    
                                    
*