
40700700:000076009
  1  1  1    1   1
  1  1  1 G  1   1
  1E 1  1    1 E 1
  1  1  1 H  1   1
  1  1  1    1   1
306006706007060009
1     1    1     1
1F  G 1 H  1G  F 1
800000:0000:000705
1     1    1   1  
1     1 F  1   1  
1 L   1    1K  1  
800000:0000:000602
1     1    1     1
1  H  1 G  1  F  1
1     1    1     1
400000:0000:000009
      1    1     1
      1    1E  F 1
  D   1 B  1     1
30000060000:000009
1          1     1
1 G  H  G  1     1
1          1 I   1
800000700006000009
1     1          1
1     1    G     1
1 K   1 E     E  1
800000:00000700009
1     1     1    1
1  F  1     1    1
1     1     1 H  1
1  E  1     1    1
1     1 A   1    1
800000:00000:00009
1     1     1    1
1 G F 1 G   1F G 1
407000600700600009
  1      1       1
  1    H 1     E 1
  1      1       1
  1 J    1 C     1
306000000600000009
1                1
1G      F      G 1
1                1
807000000000000709
1 1            1 1
1 1G         G 1 1
1 1            1 1
1 1E    D    E 1 1
1 1            1 1
806000070000700609
1      1    1    1
1      1    1    1
1 C  E 1B   1 I  1
8000000:0000607005
1      1      1   
1  G   1  E   1   
1      1      1   
8000000:0007006002
1      1   1     1
1F   F 1 G 1     1
1      1   1 D   1
1  H   1   1     1
40070006000:000705
   1       1   1  
   1  E    1   1  
300:0000000:000602
1  1       1     1
1  1       1F  G 1
1  1       1     1
1E 1       1 E   1
1  1 A     1     1
800600070006000009
1      1         1
1G   H 1F  G   F 1
8000000:0000000009
1      1         1
1      1         1
1      1       E 1
1 A    1  A      1
4007000:0000070009
*

40700700:000076009
  1  1  1    1   1
  1  1  1 G  1   1
  1E 1  1    1 E 1
  1  1  1 H  1   1
  1  1  1    1   1
306006706007060009
1     1    1     1
1F  G 1 H  1G  F 1
800000:0000:000705
1     1    1   1  
1     1 F  1   1  
1 L   1    1K  1  
800000:0000:000602
1     1    1     1
1  H  1 G  1  F  1
1     1    1     1
400000:0000:000009
      1    1     1
      1    1E  F 1
  D   1 B  1     1
30000060000:000009
1          1     1
1 G  H  G  1     1
1          1 I   1
800000700006000009
1     1          1
1     1    G     1
1 K   1 E     E  1
800000:00000700009
1     1     1    1
1  F  1     1    1
1     1     1 H  1
1  E  1     1    1
1     1 A   1    1
800000:00000:00009
1     1     1    1
1 G F 1 G   1F G 1
407000600700600009
  1      1       1
  1    H 1     E 1
  1      1       1
  1 J    1 C     1
306000000600000009
1                1
1G      F      G 1
1                1
807000000000000709
1 1            1 1
1 1G         G 1 1
1 1            1 1
1 1E    D    E 1 1
1 1            1 1
806000070000700609
1      1    1    1
1      1    1    1
1 C  E 1B   1 I  1
8000000:0000607005
1      1      1   
1  G   1  E   1   
1      1      1   
8000000:0007006002
1      1   1     1
1F   F 1 G 1     1
1      1   1 D   1
1  H   1   1     1
40070006000:000705
   1       1   1  
   1  E    1   1  
300:0000000:000602
1  1       1     1
1  1       1F  G 1
1  1       1     1
1E 1       1 E   1
1  1 A     1     1
800600070006000009
1      1         1
1G   H 1F  G   F 1
8000000:0000000009
1      1         1
1      1         1
1      1       E 1
1 A    1  A      1
4007000:0000070009
*
1 111 11111 11111 111111111 1111111 
                                    
1                                 1 
1                                 1 
1                                 1 
1                                 1 
1 11111111118 11111111: 1111111 111 
                                    
1           1         1       1     
1           1         1       1     
1           1         1       1     
1           1         1       1     
1           1         1       1     
1           1         1       1     
1 11111111111 111111111 1111111 111 
1           1         1           1 
1           1         1           1 
1 11111111111 111111111 11111111113 
            1         1           1 
            1         1           1 
            1         1           1 
            1         1           1 
            1         1           1 
            1         1           1 
2 11111111111 111111111 11111111111 
                                    
1                     1           1 
1                     1           1 
1                     1           1 
1                     1           1 
1                     1           1 
1                     1           1 
1 11111111111 111111111 11111111111 
                                    
1           1                     1 
1           1                     1 
1           1                     1 
1           1                     1 
1           1                     1 
1           1                     1 
1 11111111111 11111111111 111111115 
                                    
1           1           1         1 
1           1           1         1 
1           1           1         1 
1           1           1         1 
1           1           1         1 
1           1           1         1 
1           1           1         1 
1           1           1         1 
1           1           1         1 
1           1           1         1 
3 11111111111 11111111111 111111111 
                                    
1                                 1 
1                                 1 
1                                 1 
1                                 1 
1 111 1111111111111 111111111111111 
                                    
    1             1               1 
    1             1               1 
    1             1               1 
    1             1               1 
    1             1               1 
    1             1               1 
    1             1               1 
    1             1               1 
1 111 111111111111: 111111111111111 
                                    
1                                 1 
1                                 1 
1                                 1 
1                                 1 
1                                 1 
1                                 1 
1 111111131115111121111511131111111 
                                    
1                                 1 
1                                 1 
1                                 1 
1                                 1 
1                                 1 
1                                 1 
1                                 1 
1                                 1 
1                                 1 
1                                 1 
1 1111111111111 111111111 111111111 
                                    
1             1         1         1 
1             1         1         1 
1             1         1         1 
1             1         1         1 
1             1         1         1 
1             1         1         1 
1 1111111111111 111111111 11B 11111 
                                    
1             1             1       
1             1             1       
1             1             1       
1             1             1       
1             1             1       
1             1             1       
6 1111111111111 1111111 11111 11111 
                                    
1             1       1           1 
1             1       1           1 
1             1       1           1 
1             1       1           1 
1             1       1           1 
1             1       1           1 
1             1       1           1 
1             1       1           1 
1 11111 1111117 1111112 1111111 111 
                                    
      1               1       1     
      1               1       1     
      1               1       1     
      1               1       1     
1 11111 111111111111111 1111111 111 
                                    
1     1               1           1 
1     1               1           1 
1     1               1           1 
1     1               1           1 
1     1               1           1 
1     1               1           1 
1     1               1           1 
1     1               1           1 
1     1               1           1 
1     1               1           1 
1 11111 1111111 1111111 11111111113 
                                    
1             1                   1 
1             1                   1 
1             1                   1 
1             1                   1 
4 1111111111111 1111111111111111111 
                                    
1             1                   1 
1             1                   1 
1             1                   1 
1             1                   1 
1             1                   1 
1             1                   1 
1             1                   1 
1             1                   1 
1 11111 1111112 11111111111 1111111 
*