Textures/garden2.bmp
8 0
8 124
0
  300000000002    
  1          1    
  1Y Z Z Z [ 1    
  400700000705    
     1     1      
   C 1 D   1B     
     1     1      
    360070062     
    1   1   1     
    1E  1 F 1     
    800060009     
    1       1     
    1G    H 1     
    470070075     
     1  1  1      
     1\ 1\ 1      
 3007600:00:000002
 1  1   1  1     1
 47060076009C B  1
  1    1   1     1
  1D C 1 B 8007075
  1    1   1  1 1 
  80000:000:00609 
  1    1   1    1 
  1C   1 H 1Y [ 1 
  40700:000:00075 
    1  1   1   1  
    800:00062  1  
    1  1    8009  
    1J 1    1  1  
  3067060700:005  
  1  1   1  1     
  1\ 1   1X 1     
  800:0009  1     
  1  1   1W 8002  
  1  1 I 1  1  1  
  1  1   1V 1\ 1  
  40760706076009  
    1  1   1   1  
    1  1D  1C  1  
   3600670067005  
   1    1   1     
   1Y [ 1 B 1     
   8070060706002  
   1 1    1    1  
   1 1B C 1S U 802
   80607009    1 1
   1   1  1M O 1 1
  36000:0760700:09
  1    1 1  1  1 1
  1S U 806009X 1 1
  1    1    1  809
  1M O 1E F 1W 1 1
  40700:07009  1 1
    1  1 1  1V 1 1
    1  80670600:09
 300:009  1    1 1
 1  1  1J 1  K 1 1
 1D 1J 800:0700:05
 8006009  1 1  1  
 1     1\ 1 1\ 1  
 1C B  800:0:009  
 1     1  1 1  1  
 1  F  1\ 1 1\ 1  
 800007600:06075  
 1    1   1   1   
 1S U 1 C 1B  1   
 1    1   1   1   
 1M O 8000:0005   
3607009   1       
1  1  1 B 1 C     
1C 1B 1   1       
800:00:0009       
1  1  1   1       
1G 1H 1I  1       
800:006007602     
1  1     1  1     
1X 1B  B 1X 1     
1  802 309  1     
1V 1 1 1 1V 1     
800:06067607602   
1  1    1  1  1   
1  1S U 1I 1  1   
4009    800:009   
   1P R 1  1  1   
   1    1  1J 1   
   1M O 8076076002
300600705 1  1   1
1     1   1C 1 B 1
1     1 B 1  1   1
1   30:000:00:0705
80009 1   1  1 1  
1   1 1   1C 1 1  
1C  806000:00609  
80009     1    1  
1   1E F  1G H 1  
4070670070600705  
  1  1  1    1    
  1  1  1Y [ 1    
  800:00:00009    
  1  1  1    1    
  1  1K 1 J  1    
  470670600709    
   1  1    1 1    
   1  1S U 1 1    
   8009    809    
   1  1M O 1 1    
   80060000:05    
   1       1      
   1B  C B 1      
300607007009      
1    1  1  1      
1Y [ 1  1  1      
40700:00600:002   
  1  1     1  1   
  1  1  D  1  1   
  4009     8005   
     1     1      
     1C  C 1      
     400;005      
        1         
        1         
        1         
        1         
        1         
*
    1 111111111111111111111         
                                    
    1                     1         
    1                     1         
    1                     1         
    1                     1         
    1 11111 11111111111 111         
                                    
          1           1             
          1           1             
          1           1             
          1           1             
          1           1             
          1           1             
        1 1 11111 11111 4           
                                    
        1       1       1           
        1       1       1           
        1       1       1           
        1       1       1           
        1 1111111 1111111           
                                    
        1               1           
        1               1           
        1               1           
        1               1           
        3 1 11112 11111 1           
                                    
          1     1     1             
          1     1     1             
          1     1     1             
          1     1     1             
  1 11111 1 11111 11111 11111111111 
                                    
  1     1       1     1           1 
  1     1       1     1           1 
  1 1 111 11111 1 11111           1 
                                  1 
    1         1       1           1 
    1         1       1           1 
    1         1       1 11111 111 1 
    1         1                     
    1         1       1     1   1   
    1         1       1     1   1   
    8 111111111 1111111 11111 117   
                                    
    1         1       1         1   
    1         1       1         1   
    1         1       1         1   
    1         1       1         1   
    1 111 11111 1111111 1111111 1   
                                    
        1     1       1       1     
        1     1       1       1     
        1 11111 1111111 1     1     
                              1     
        1     1         1 11111     
        1     1                     
        1     1         1     1     
        1     1         1     1     
    1 111 1 111 111 11111 11111     
                                    
    1     1       1     1           
    1     1       1     1           
    1     1       1     1           
    1     1       1     1           
    1 1111: 1111111     1           
                        1           
    1     1       1     : 11116     
    1     1       1                 
    1     1       1     1     1     
    1     1       1     1     1     
    1     1       1     1     1     
    1     1       1     1     1     
    3 111 1 111 111 111 1 11111     
                                    
        1     1       1       1     
        1     1       1       1     
        1     1       1       1     
        1     1       1       1     
      5 1 11111 1 11111 1 11111     
                                    
      1         1       1           
      1         1       1           
      1         1       1           
      1         1       1           
      1 111 11112 111 111 11111     
                                    
      1   1         1         1     
      1   1         1         1     
      1   1         1         1 114 
      1   1         1               
      1 111 111 11111         1   1 
                              1   1 
      1       1     1         1   1 
      1       1     1         1   1 
    1 1 1111111 111 1 111 11111 111 
                                    
    1         1   1     1     1   1 
    1         1   1     1     1   1 
    1         1 111 11111     1   1 
    1                         1   1 
    1         1         1     1 111 
    1         1         1           
    1         1         1     1   1 
    1         1         1     1   1 
    3 111 11111 111 11111     1   1 
                              1   1 
        1     1   1     1     1   1 
        1     1   1     1     1   1 
        1     1 111 1 111 1111: 111 
        1                           
  1 11114 11111     1         1   1 
                    1         1   1 
  1     1     1     1         1   1 
  1     1     1     1         1   1 
  1     1     1 11111 111 11111 111 
  1     1                           
  1 11111 11111     1   1     1     
                    1   1     1     
  1           1     1   1     1     
  1           1     1   1     1     
  1           1 11111 111 11111     
  1                                 
  1           1     1   1     1     
  1           1     1   1     1     
  1           1     1   1     1     
  1           1     1   1     1     
  6 111111111 1 11111 111 111 1     
                                    
  1         1       1       1       
  1         1       1       1       
  1         1       1       1       
  1         1       1       1       
  1         1       1       1       
  1         1       1       1       
  1         1 111111= 1111111       
  1                                 
1 1 111 11111       1               
                    1               
1     1     1       1               
1     1     1       1               
1     1     1       1               
1     1     1       1               
1 11111 11111 1111111               
                                    
1     1     1       1               
1     1     1       1               
1     1     1       1               
1     1     1       1               
1 11111 11113 11111 1 111           
                                    
1     1           1     1           
1     1           1     1           
1     1           1     1           
1     1           1     1           
1     1 111   1 111     1           
1                       1           
1     1   1   1   1     1           
1     1   1   1   1     1           
7 11111 111 111 1 1 111 1 118       
                                    
1     1         1     1     1       
1     1         1     1     1       
1     1         1     1     1       
1     1         1     1     1       
1 11111         1 11111 11111       
                                    
      1         1     1     1       
      1         1     1     1       
      1         1     1     1       
      1         1     1     1       
      1         1 111 1 111 1 11116 
      1                             
1 11113 11111 111   1     1       1 
                    1     1       1 
1           1       1     1       1 
1           1       1     1       1 
1           1       1     1       1 
1           1       1     1       1 
1       1 111 1111115 11111 111 111 
1                                   
7 1111116   1       1     1   1     
            1       1     1   1     
1       1   1       1     1   1     
1       1   1       1     1   1     
1       4 111 1111111 11111 111     
5                                   
1 1111111           1         1     
                    1         1     
1       1           1         1     
1       1           1         1     
2 111 113 1 11111 11< 11111 111     
                                    
    1     1     1         1         
    1     1     1         1         
    1     1     1         1         
    1     1     1         1         
    1 11111 11111 111111111         
                                    
    1     1     1         1         
    1     1     1         1         
    1     1     1         1         
    1     1     1         1         
    1 1 111 1 111 11113 111         
                                    
      1     1         1   1         
      1     1         1   1         
      1     1         1   1         
      1     1         1   1         
      1 11111         1 111         
                                    
      1     1         1   1         
      1     1         1   1         
      : 11111 111111111 111         
                                    
      1               1             
      1               1             
      1               1             
      1               1             
1 11111 111 11111 11111             
                                    
1         1     1     1             
1         1     1     1             
1         1     1     1             
1         1     1     1             
3 111 11111 11111 11111 11113       
                                    
    1     1           1     1       
    1     1           1     1       
    1     1           1     1       
    1     1           1     1       
    4 11111           1 11114       
                                    
          1           1             
          1           1             
          1           1             
          1           1             
          1 11111 11111             
                                    
                                    
                                    
                                    
                                    
                                    
                                    
                                    
                                    
                                    
                                    
*