Textures/classic6.bmp
8 0
8 196
0
300000000000000002
1                1
1                1
400070000007000005
    1      1      
    1      1      
3000:000000:000002
1   1      1     1
1   1      1     1
800760070006700005
1  1   1    1     
1  1   1    1     
800:0009  306002  
1  1   1  1    1  
1  4000:009    1  
1      1  800005  
1      1  1       
40700009  1       
  1    4709       
  1     1 1       
  8002  1 1       
  1  1  1 1       
  1  1  1 1       
  1  800:060000002
  1  1  1        1
  1  1  1        1
30600600:000000009
1       1        1
1       8002     1
1       1  1     1
400700009  4007005
   1    1     1   
   1    1     1   
   407009     1   
     1  8000705   
     1  1   1     
     1  1   1     
  3006075   1     
  1    1    8002  
  1    1    1  1  
  1    1    1  1  
  1  30600705  1  
  1  1    1    1  
  1  1    1    1  
  1  1    1    1  
  400:0070607005  
     1  1   1     
     1  1   1     
     4705   8002  
      1     1  1  
      1  3005  1  
  30009  1     1  
  1   4075 30009  
  1     1  1   1  
  1     1  1   1  
  407000:00602 42 
    1   1    1  1 
    1   1    1  1 
    1   1    1  1 
    8000:0000:009 
    1   1    1  1 
    1   1    1  1 
 3005   4002 1  1 
 1         1 1  1 
 1         809  1 
 1         1 1  1 
 8007007007609  1 
 1  1  1  1  8005 
 1  1  1  1  1    
 1  1  1  1  1    
 1  1  1  1  1    
 400670:076005    
     1 1 1        
     1 1 1        
 3000:06060000002 
 1   1          1 
 1   40000002   1 
 1          1   1 
 4000000;00060005 
        1         
        1         
        1         
        1         
        1         
        1         
*
1 111111111111111111111111111111111 
                                    
1                                 1 
1                                 1 
1                                 1 
1                                 1 
1 1111111 1111111111111 11111111111 
                                    
        1             1             
        1             1             
        1             1             
        1             1             
1 1111111 1111111211111 11111111111 
                                    
1       1             1           1 
1       1             1           3 
1       1             1           1 
1       1             1           B 
4 11111 1 11111 1111111 1 111111111 
                                    
1     1       1         1           
1     1       1         1           
1     1       1         1           
1     1       1         1           
1 11111 1111111     1 111 11111     
                                    
1     1       1     1         1     
1     1       1     1         1     
1     1 1111111 11113         1     
1                             1     
1             1     1 111111111     
1             1                     
1             1     1               
1             1     1               
1 11= 111111111     1               
                    1               
    1         1 1 111               
    1                               
    1           1   1               
    1           1   1               
    1 11111     1   1               
                1   1               
    1     1     1   1               
    1     1     1   1               
    1     1     1   1               
    1     1     1   1               
    1     1 11111 111 1111111111111 
    1                               
    1     1     1                 1 
    1     1     1                 1 
    1     1     1                 1 
    1     1     1                 1 
1 111 11111 11111 11111111111111113 
                                    
1               1                 1 
1               1                 1 
2               1 11111           1 
1                                 1 
1               1     1           1 
1               1     1           1 
1 11111 111111117     1 11111 11111 
                                    
      1         1           1       
      1         1           1       
      1         1           1       
      1         1           1       
      1 111 11111           1       
                            1       
          1     1 1111111 111       
          1                         
          1     1       1           
          1     1       1           
          1     1       1           
          1     1       1           
    1 11111 111 1       1           
                        1           
    1         1         1 11111     
    1         1                     
    1         1         1     1     
    1         1         1     1     
    1         1         1     1     
    1         1         1     1     
    1     1 111 11116 111     1     
    :                         1     
    1     1         1         1     
    1     1         1         1     
    1     1         1         1     
    1     1         1         1     
    1     1         1         1     
    1     1         1         1     
    1 11111 11111 111 111 11111     
                                    
          1     1       1           
          1     1       1           
          1     1       1           
          1     1       1           
          1 1 111       1 11111     
                                    
            1           1     1     
            1           1     1     
            1     1 11111     1     
            1                 1     
    2 1111111     1           1     
                  1           1     
    1       1 111 1   B 1111111     
    1                               
    1           1     1       1     
    1           1     1       1     
    1           1     1       1     
    1           1     1       1     
    1 111 1111111 11111 111   1 1   
                                    
        1       1         1     1   
        1       1         1     1   
        1       1         1     1   
        1       1         1     1   
        1       1         1     1   
        1       1         1     1   
        1 1111111 111111111 11111   
                                    
        1       1         1     1   
        1       1         1     1   
        1       1         1     1   
        1       1         1     1   
  1 11111       1 11111   1     1   
                          1     1   
  1                   1   1     1   
  1                   1   1     8   
  1                   1 111     1   
  1                             1   
  1                   1   1     1   
  1                   1   1     1   
  1 11111 1111: 11111 1 111     1   
                                1   
  1     1     1     1     1 11111   
  1     1     1     1               
  1     1     1     1     1         
  1     1     1     1     1         
  1     1     1     1     1         
  1     1     1     1     1         
  1     1     1     1     1         
  1     1     1     1     1         
  1 11111 1 111 111 1 11111         
                                    
          1   1   1                 
          1   1   1                 
          1   1   1                 
          1   1   1                 
  1 1111111 111 111 1111111111111   
                                    
  1       1                     1   
  1       1                     1   
  1       1 1111117111111       1   
  1                             1   
  1                     1       1   
  1                     1       1   
  1 111111111111  1111111 1111111   
                                    
                                    
                                    
                                    
                                    
                                    
                                    
                                    
                                    
                                    
                                    
                                    
                                    
*