Textures/garden1.bmp
8 0
12 118
0
   307007002      
   1 1 362 1F     
   1 1 1 1 1      
   80:060609G     
   1 1     1      
   809  A  1H     
   1 802   1      
   1 1 1   1E     
   806067009      
   1    1  1      
 3067000:00:002   
 1  1   1  1  1   
 1  1   1  1  1   
 8006000600:009   
 1  3002   1  1   
 1  1  1 D 1C 1   
 1F 1\ 1   1  1   
 1  80060706005   
36709    1        
1 1 1Y [ 1E G H   
1 1 80000:002     
809 1    1  1     
1 1 40700:075     
1 1   1  1 1      
80:000:005 1J     
1 1   1    1      
406000:0070602    
      1  1   1    
   300600:0009    
   1     1   1    
   8007009 K 802  
 G 1  1  1   1 1  
   400:00:000675  
      1  1    1   
      1\ 1 C  1   
 E 300607607009   
   1    1  1  1   
   40070:00:005   
      1 1  1      
   30060:076002   
   1    1 1   1   
   1F H 1 1 A 1   
   4070060:0076702
     1    1  1 1 1
     407009  1 809
       1  1G 1 1 1
       1D 4075 1 1
       1    1  809
     30600706705 1
     1    1  1   1
     1S U 800:0005
  3009    1  1    
  1  1M O 1  1    
  1  807006009    
  4009 1     1    
     1 1B  C 1    
   309 8007009    
   1 1 1  1  1    
   80:06009D 1    
   1 1    1  1    
   80:00076075    
   1 1   1  1     
   1 1  36009     
  3609  1   1     
  1  1  1B  1     
  800:00:0009 G   
  1  1  1   1     
  80060760006002  
  1    1       1  
  1F 30600007009  
  1  1      1  1  
  1E 1C D C 1J 1  
  8009      4009  
  1  1  B      1  
  1I 80070007009  
  1  1  1   1  1  
  800:0060706009  
  1  1    1    1  
  1C 1Y [ 1Y [ 1  
  80060000:00709  
  1       1  1 1  
  1 G F E 1H 1 1  
  80000700:00609  
  1    1  1    1  
  1S U 1C 1Y [ 1  
  1    800:00705  
  1M O 1  1  1    
  400009D 1C 1B   
       8006075    
       1    1     
   E G 1Y [ 1     
       8007062    
   F H 1  1  1    
       1\ 1J 1    
    300:006009    
    1  1     1    
    1A 1C  D 1    
    800:007009    
    1  1  1  1    
   36076009C 1    
   1  1   8009    
   8009B  1  1    
   1  80009K 1    
   1  1   1  1    
   4709   800602  
    1 80009    1  
    1 1   1    1  
    1 1   1E G 1  
    809   807009  
    1 1 D 1 1  1  
    1 1   1 1H 1  
    406700:06009  
       1  1    1  
       1\ 1 J  1  
       40060;005  
            1     
            1     
            1     
            1     
*
      1 111 11111 11111             
                                    
      1   1   1 1 1   1             
      1   1           1             
      1   1   1   1   1             
      1   1   1   1   1             
      1 111 111 111 111             
                                    
      1   1           1             
      1   1           1             
      1 111           1             
                      1             
      1   1 111       1             
      1               1             
      1   1   1       1             
      1   1   1       1             
      1 111 111 1 11111             
                                    
      1         1     1             
      1         1     1             
  1 111 2 1111111 11111 11111       
                                    
  1     1       1     1     1       
  1     1       1     1     1       
  1     1       1     1     1       
  1     1       1     1     1       
  1 11111 1111111 11111 11111       
                                    
  1     1 11111       1     1       
  1                   1     1       
  1     1     1       1     1       
  1     1     1       1     1       
  1     1     1       1     1       
  1     1     1       1     1       
  1     1 11111 111 115 11111       
  1                                 
1 1 1 111         1                 
                  1                 
1   1   1         1                 
1   1   1         1                 
1   1   1 111111111 11111           
1   1                               
1 111   1         1     1           
        1         1     1           
1   1   6 111 11111 111 1           
1   1                               
1   1       1     1   1             
1   1       1     1   1             
1 11: 1111111 11111   1             
                      1             
1   1       1         1             
1   1       1         1             
< 111 1111111 11111 111 111         
                                    
            1     1       1         
            1     1       1         
      1 11114 11111 1111111         
                                    
      1           1       1         
      1           1       1         
      1 11111 11111       1 111     
                                    
      1     1     1       1   1     
      1     1     1       1   1     
      1 11111 11111 1111111 1 1     
                                    
            1     1         1       
            1     1         1       
            1     1         1       
            1     1         1       
      1 11111 111 1 113 11111       
                                    
      1         1     1     1       
      1         1     1     1       
      1 11111 111 11111 11111       
                                    
            1   1     1             
            1   1     1             
      1 11111 111 111 1 11111       
                                    
      1         1   1       1       
      1         1   1       1       
      1         1   1       1       
      1         1   1       1       
      1 112 11111 111 11111 1 = 111 
                                    
          1         1     1   1   1 
          1         1     1   1   1 
          1 111 11111     1   1 111 
                          1         
              1     1     1   1   1 
              1     1     1   1   1 
              1     1 111 1   1   1 
              1               1   1 
              1         1     1 111 
              1         1           
          1 111 11111 111 1 111   1 
                                  1 
          1         1     1       1 
          1         1     1       1 
          1         1 11111 1111118 
          1                         
    1 11111         1     1         
                    1     1         
    1     1         1     1         
    1     1         1     1         
    1     1 111 11111 11111         
    1                               
    7 11111   1           1         
              1           1         
          1   1           1         
          1   1           1         
      1 111   1 11111 11111         
                                    
      1   1   1     1     1         
      1   1   1     1     1         
      1 111 111 11111     1         
                          1         
      1   1         1     1         
      1   1         1     1         
      1 111 1111111 1 111 5         
                                    
      1   1       1     1           
      1   1       1     1           
      1   1     1 1 11111           
      1   1                         
    1 1 111     1       1           
                1       1           
    1     1     1       1           
    1     1     1       1           
    1 11111 11111 1111111           
                                    
    1     1     1       1           
    1     1     1       1           
    1 11111 111 1 1111111 11111     
                                    
    1         1               1     
    1         1               1     
    1     1 11= 111111111 11113     
    1                               
    1     1             1     1     
    1     1             1     1     
    1     1             1     1     
    1     1             1     1     
    1 11111             1 11111     
                                    
    1     1                   1     
    1     1                   1     
    1     1 11111 1111111 11111     
    1                               
    1     1     1       1     1     
    1     1     1       1     1     
    1 11111 11111 111 111 11111     
                                    
    1     1         1         1     
    1     1         1         1     
    1     1         1         1     
    1     1         1         1     
    1 11111 111111111 11111 116     
                                    
    1               1     1   1     
    1               1     1   1     
    1               1     1   1     
    1               1     1   1     
    : 111111111 11111 11111 111     
                                    
    1         1     1         1     
    1         1     1         1     
    1         1     1         1     
    1         1     1         1     
    1         1 11111 11111 111     
    1                               
    1         1     1     1         
    1         1     1     1         
    1 111111111     1     1         
                    1     1         
              1 11111 111 1         
                                    
              1         1           
              1         1           
              1         1           
              1         1           
              1 11111 114 1         
                                    
              1     1     1         
              1     1     1         
              1     1     1         
              1     1     1         
        1 11111 11111 11111         
                                    
        1     1           1         
        1     1           1         
        1     1           1         
        1     1           1         
        1 11111 11112 11111         
                                    
        1     1     1     1         
        1     1     1     1         
      1 1 111 1 11111     1         
                          1         
      1     1       1 11111         
      1     1                       
      1 11111       1     1         
                    1     1         
      1     1 1111111     1         
      1                   1         
      1     1       1     1         
      1     1       1     1         
      1 4 111       1 11111 111     
                                    
        1   1 1111111         1     
        1                     1     
        1   1       1         1     
        1   1       1         1     
        1   1       1         1     
        1   1       1         1     
        1 111       1 111 11113     
                                    
        1   1       1   1     1     
        1   1       1   1     1     
        1   1       1   1     1     
        1   1       1   1     1     
        1 111 1 11111 111 11111     
                                    
              1     1         1     
              1     1         1     
              1     1         1     
              1     1         1     
              1 11111 111 11111     
                                    
                                    
                                    
                                    
                                    
                                    
                                    
                                    
                                    
*