Textures/grave2.bmp
9 0
8 99
0
       3007002     
       1  1  1     
       1D 1B 1     
  A    1  1  1     
       80060762    
       1    1 1    
       1 C  1 1    
     309    809    
   F 1 470075 1    
     1  1  1  1    
     1  1E 1  1    
 30076076006005    
 1  1  1           
 1  1C 1 B  D      
 4009  870007002   
    1  11   1  1   
    47051   1  1   
     1  1 A 8009   
     1  1   1  1   
 A   400:0005  1   
        1      1   
 3007000:0007009   
 1  1   1   1  1   
 1  1 F 1F  1  1   
 1  1   1   1  1   
3670:000:000:0762  
1 1 1   1   1 1 1  
805 1 D 1 E 1 409  
1   1   1   1   1  
1 A 8000:0009 A 1  
80009   1   80009  
1   1   1   1   1  
1 F 1   1   1 F 1  
80006070607060009  
1     1   1     1  
1     1   1     1  
80007060706700009  
1   1   1  1    1  
8000:0009  1  305  
1   1   1  1  1    
1 F 1 F 800:009 A  
1   1   1  1  1    
800060009  1  1    
1       800:009    
1 D   E 1  1  1    
1       1  1  1    
47007000:006705    
 1  1   1   1      
 1  1 F 1 F 1      
 1  1   1   1      
 8006700:0709      
 1   1  1 1 1      
 1   1  1 1 1      
 4000:00:0:09      
     1  1 1 1      
     1F 1 1 1      
     1  80609      
     8009   1      
 30009  1 C 1      
 1   1  1   8002   
 1   1  1   1  1   
 8000600:0009  1   
 1      1   1  1   
 1 E  F 1   8005   
 1      80009      
 80070009   1      
 1  1   1F  1      
 1  1   1   1E     
 800:02 8000:002   
 1  1 1 1   1  1   
 4709 409   1  1   
  1 1   8000600602 
  1 1   1        1 
  8060709C  E  D 1 
  1   1 1        1 
  1 F 1 1        1 
  1   1 1F     F 1 
  4000:09        1 
      1 1B  E  A 1 
      1 8000700075 
      809   1   1  
 F  F 1 1 F 1 F 1  
      80:000:0009  
      1 1   1   1  
      809   1   1  
 D    1 8000:0005  
    F 1 1   1      
      1 1   1 E    
      809 A 1      
B  C  1 80009      
      1 1   1 F F  
      1 1   1      
300000:06070600002 
1     1   1      1 
1 B   1 E 1   D  1 
40000060;060000005 
        1          
        1          
 A    F 1 F    A   
        1          
                   
*
              1 11111 11111           
                                      
              1     1     1           
              1     1     1           
              1     1     1           
              1     1     1           
              1     1     1           
              1     1     1           
              4 11111 111 5 1         
                                      
              1         1   1         
              1         1   1         
              1         1   1         
              1         1   1         
          1 111         1 111         
                                      
          1   1 1 11111 1   1         
          1                 1         
          1     1     1     1         
          1     1     1     1         
          1     1     1     1         
          1     1     1     1         
  1 11111 1 111 1 11111 11112         
                                      
  1     1     1                       
  1     1     1                       
  1     1     1                       
  1     1     1                       
  1 11111     1 1 1111111 11111       
                                      
        1     1 1       1     1       
        1     1 1       1     1       
        1 1 111 1       1     1       
                1       1     1       
          1     1       1 11111       
          1     1                     
          1     1       1     1       
          1     1       1     1       
          1 11113 1111111     1       
                              1       
                1             1       
                1             1       
  1 11111 1111111 1111111 11111       
                                      
  1     1       1       1     1       
  1     1       1       1     1       
  1     1       1       1     1       
  1     1       1       1     1       
  1     1       1       1     1       
  1     1       1       1     1       
1 1 1 111 1111111 1111111 111 1 1     
                                      
1   1   1       1       1   1   1     
1   1   1       1       1   1   1     
1 111   1       1       1   1 111     
        1       1       1             
1       1       1       1       1     
1       1       1       1       1     
1       ; 1111111 1111118       1     
1                               1     
1 1111111       1       1 1111111     
                1                     
1       1       1       1       1     
1       1       1       1       1     
1       1       1       1       1     
1       1       1       1       1     
1 1111111 111 111 111 111 1111111     
                                      
1           1       1           1     
1           1       1           1     
1           1       1           1     
1           1       1           1     
3 1111111 111 111 111 1 111111113     
                                      
1       1       1     1         1     
1       1       1     1         1     
1 1111111 1111111     1     2 111     
                      1               
1       1       1     1     1         
1       1       1     1     1         
1       1       1 11111 11111         
1       1                             
1       1       1     1     1         
1       1       1     1     1         
3 1111111 1111111     1     1         
                      1     1         
1               1 11111 11111         
1                                     
1               1     1     1         
1               1     1     1         
1               1     1     1         
1               1     1     1         
1 4 11111 1111118 11111 1 111         
                                      
  1     1       1       1             
  1     1       1       1             
  1     1       1       1             
  1     1       1       1             
  1     1       1       1             
  1     1       1       1             
  1 11111 1 11111 116 111             
                                      
  1       1     1   1   1             
  1       1     1   1   1             
  1       1     1   1   1             
  1       1     1   1   1             
  1 111111: 11111 111 111             
                                      
          1     1   1   1             
          1     1   1   1             
          1     1   1   1             
          1     1   1   1             
          1     1 111 111             
          1                           
          1 11111       1             
                        1             
  3 1111111     1       1             
                1       1             
  1       1     1       1 11111       
  1       1     1                     
  1       1     1       1     1       
  1       1     1       1     1       
  1 1111111 11116 1111111     1       
                              1       
  1             1       1     1       
  1             1       1     1       
  1             1       > 11111       
  1             1                     
  1             1 1111111             
  1                                   
  1 11111 1111111       1             
                        1             
  1     1       1       1             
  1     1       1       1             
  1     1       1       1             
  1     1       1       1             
  1 11111 115   1 1111111 11111       
                                      
  1     1   1   1       1     1       
  1     1   1   1       1     1       
  ; 1 113   1 111       1     1       
                        1     1       
    1   1       2 1111111 11111 114   
    1   1                             
    1   1       1                 1   
    1   1       1                 1   
    1 111 111 111                 1   
                                  1   
    1       1   1                 1   
    1       1   1                 1   
    1       1   1                 1   
    1       1   1                 1   
    1       1   1                 1   
    1       1   1                 1   
    1 1111117 111                 1   
                                  1   
            1   1                 1   
            1   1                 1   
            1   3 1111111 1111111 6   
            1                         
            1 111       1       1     
                        1       1     
            1   1       1       1     
            1   1       1       1     
            1 111 1111111 1111111     
                                      
            1   1       1       1     
            1   1       1       1     
            1 111       1       1     
                        1       1     
            1   1 1111115 1111111     
            1                         
            1   1       1             
            1   1       1             
            1   1       1             
            1   1       1             
            1 111       1             
                        1             
            1   1 1111111             
            1                         
            1   1       1             
            1   1       1             
            1   1       1             
            1   1       1             
1 11111111118 111 111 111 111111114   
                                      
1           1       1             1   
1           1       1             1   
1           1       1             1   
1           1       1             1   
3 11111111111 11  111 1111111111111   
                                      
                                      
                                      
                                      
                                      
                                      
                                      
                                      
                                      
                                      
                                      
*