Textures/grave1.bmp
8 0
8 106
0
30007000700070002 
1   1   1   1   1 
1   1G  1 G 1   1 
1   1   1   1   1 
8000:000:000:0009 
1   1   1   1   1 
1K  1   1 J 1 H 1 
1   1 30:02 1   1 
8000:09 1 80:0009 
1   1 40:05 1   1 
1   1   1   1   1 
1   1   1   1   1 
40076700:00767005 
   1 1  1  1 1    
   1 1I 1L 1 1    
   409  1  805 G  
     1  1  1      
   H 800:009      
     1  1  1      
     1  1  1 I LI 
     800:009      
     1  1  1      
     8006009      
     1     1      
     1K  J 1      
     1     1      
   30600700602    
   1    1    1    
 G 1 300:002 1G   
   1 1  1  1 1    
   1 1I 1L 1 1    
   80:00:00:09    
   1 1  1  1 1    
   1 1L 1I 1 1    
 G 1 400:005 1G   
   1    1    1    
   40070:07005    
      1 1 1       
      1 1 1       
   K  80:09 H     
    309 1 802     
    1 1 1 1 1     
G   1 1 1 1 1  G  
    40:0:0:05     
      1 1 1       
      1 1 1       
300700:060:007002 
1  1  1   1  1  1 
4076705 L 4076705 
  1 1       1 1   
  1 407000705 1J  
  1   1   1   1   
  8000607060009   
  1     1     1   
  807000:000709   
K 1 1   1   1 1   
  805 I 1I  409   
  1     1     1   
  1G 300:002G 1   
  1  1  1  1  1   
  400:00:00:005   
     1  1  1      
   30600:00602    
   1    1    1    
   1L   1  L 1    
   40700:00705    
     1  1  1      
     1  1  1      
     470:075      
      1 1 1       
  J I 1 1 1 G     
      80:09       
      1 1 1       
 3070060:0600702  
 1 1    1    1 1  
 1 1 K  1  H 1 1  
 1 40700:00705 1  
 1   1  1  1   1  
 80009G 1G 80009  
 1   1  1  1   1  
 1   800:009   1  
 40705  1  40705  
   1    1    1    
   80070:07009    
3009  1 1 1  8002 
1  1  80:09  1  1 
1  1  1 1 1  1  1 
8009L 1 1 1I 8009 
1  80060:06009  1 
1  1    1    1  1 
4709 J  1    8075 
 1 1    1 K  1 1  
 1 40070:07005 1  
 1    1 1 1    1  
 4007060:0607005  
    1   1   1     
    1   1   1     
    1I  1 I 1     
    1   1   1     
    800060009     
    1       1     
    1       1     
    4000;0005     
        1         
        1         
    G   1  G      
        1         
*
1 1111111 1111111 1111111 1111111   
                                    
1       1       1       1       1   
1       1       1       1       1   
1       1       1       1       1   
1       1       1       1       1   
1       1       1       1       1   
1       1       1       1       1   
1 1111111 1111111 1111111 1111111   
                                    
1       1       1       1       1   
1       1       1       1       1   
1       1       1       1       1   
1       1       1       1       1   
1       1   4 111 115   1       1   
1       1               1       1   
1 1111111 111   1   1 111 1111111   
                1                   
1       1   5 111 114   1       1   
1       1               1       1   
1       1       1       1       1   
1       1       1       1       1   
1       1       1       1       1   
1       1       1       1       1   
: 11111 1 1 11111 11111 1 1 1111:   
                                    
      1   1     1     1   1         
      1   1     1     1   1         
      1   1     1     1   1         
      1   1     1     1   1         
      1 115     1     5 111         
                1                   
          1     1     1             
          1     1     1             
          1 11111 11111             
                                    
          1     1     1             
          1     1     1             
          1     1     1             
          1     1     1             
          1 11111 11111             
                                    
          1     1     1             
          1     1     1             
          1 11111 11111             
                                    
          1           1             
          1           1             
          1           1             
          1           1             
          1           1             
          1           1             
      6 111 11111 11111 114         
                                    
      1         1         1         
      1         1         1         
      1   1 11111 11111   1         
      1                   1         
      1   1     1     1   1         
      1   1     1     1   1         
      1   1     1     1   1         
      1   1     1     1   1         
      2 111 11115 11111 112         
                                    
      1   1     1     1   1         
      1   1     1     1   1         
      1   1     1     1   1         
      1   1     1     1   1         
      1   1 11111 11111   1         
      1                   1         
      1         1         1         
      1         1         1         
      4 11111 111 111 11116         
                                    
            1   1   1               
            1   1   1               
            1   1   1               
            1   1   1               
            1 111 111               
                                    
        4 111   1   1 114           
                1                   
        1   1   1   1   1           
        1   1   1   1   1           
        1   1   >   1   1           
        1   1   1   1   1           
        5 111 111 111 115           
                                    
            1   1   1               
            1   1   1               
            1   1   1               
            1   1   1               
1 11111 11111 113 111 11111 11111   
                                    
1     1     1       1     1     1   
1     1     1       1     1     1   
1 111 1 1 111       1 111 1 1 111   
                                    
    1   1               1   1       
    1   1               1   1       
    1   4 111 1111111 114   1       
    1                       1       
    1       1       1       1       
    1       1       1       1       
    1 1111111 11; 111 1111111       
                                    
    1           1           1       
    1           1           1       
    1 111 1111111 1111111 111       
                                    
    1   1       1       1   1       
    1   1       1       1   1       
    8 111       1       1 118       
                1                   
    1           1           1       
    1           1           1       
    1     6 11111 11116     1       
    1                       1       
    1     1     1     1     1       
    1     1     1     1     1       
    1 11111 11111 11111 11111       
                                    
          1     1     1             
          1     1     1             
      1 111 11111 11111 111         
                                    
      1         1         1         
      1         :         1         
      1         1         1         
      1         1         1         
      1 111 11111 11111 111         
                                    
          1     1     1             
          1     1     1             
          1     1     1             
          1     1     1             
          3 1 111 111 3             
                                    
            1   1   1               
            1   1   1               
            1   1   1               
            1   1   1               
            1 111 111               
                                    
            1   1   1               
            1   1   1               
  2 111 11111 111 111 11111 112     
                                    
  1   1         1         1   1     
  1   1         1         1   1     
  1   1         1         1   1     
  1   1         1         1   1     
  1   1 111 11117 11111 111   1     
  1                           1     
  1       1     1     1       1     
  1       1     1     1       1     
  1 1111111     1     1 1111111     
                1                   
  1       1     1     1       1     
  1       1     1     1       1     
  1       1 11111 11111       1     
  1                           1     
  1 116 111     1     1 116 111     
                1                   
      1         1         1         
      1         1         1         
      1 11111 111 111 11111         
                                    
4 11111     1   1   1     1 11114   
            1   1   1               
1     1     1 111 111     1     1   
1     1                   1     1   
1     1     1   1   1     1     1   
1     1     1   1   1     1     1   
1 11111     1   1   1     1 11111   
            1   1   1               
1     1 11111 11; 111 11111     1   
1                               1   
1     1         1         1     1   
1     1         1         1     1   
1 2 111         1         1 112 1   
                1                   
  1   1         1         1   1     
  1   1         1         1   1     
  1   1 11111 111 111 11111   1     
  1                           1     
  1         1   1   1         1     
  1         1   1   1         1     
  1 11115 111 111 111 115 11111     
                                    
        1       1       1           
        1       1       1           
        1       1       1           
        1       1       1           
        1       1       1           
        1       1       1           
        1       1       1           
        1       1       1           
        1 1111111 1111111           
                                    
        1               1           
        1               1           
        1               1           
        1               1           
        1 111111  1111111           
                                    
                                    
                                    
                                    
                                    
                                    
                                    
                                    
                                    
*