Textures/town3.bmp
8 0
9 117
0
  30070000007002  
  1  1      1  1  
  1  1E   E 1  1  
  1  1      1  1  
  8009      8009  
  1  1  C   1  1  
  1  1      1  1  
  1  1E   E 1  1  
306706000000607602
1  1          1  1
1F 1    G     1F 1
1  1          1  1
800600700007006009
1     1    1     1
1     1    1     1
1  H  1 D  1  H  1
1     1    1     1
8007009  E 8007009
1  1  1    1  1  1
1G 1F 800009F 1G 1
8009  1    1  8009
1  1  1E   1  1  1
1  1  800009  1  1
8009  1    1  8009
1  8009    8009  1
1F 1  1 B  1  1F 1
1  1  1    1  1  1
1  8009    8009  1
8009  1 E  1  8009
1  1H 1    1H 1  1
4009  1    1  8005
   1  1 E  1  1   
   800:0000:009   
   1  1    1  1   
   1  1    1  1   
 E 8009 L  8009E  
   1  1    1  1   
   1  1    1  1   
300607600006706002
1    1      1    1
1 G  1  F   1 G  1
807006700007600709
1 1   1    1   1 1
1 1   1    1   1 1
1 1 E 1    1E  1 1
80:0009 H  8000:09
1 1   1    1   1 1
1 1   1    1   1 1
409   800009   805
  1K  1    1B  1  
  40009 G  80005  
      1    1      
  30009    80002  
  1   1 J  1   1  
  47006700760075  
   1   1  1   1   
   1E  1  1 E 1   
 3060009  8000602 
 1     1  1     1 
 1 F   1  1  F  1 
 4070706006070705 
   1 1      1 1   
   1 1  G   1 1   
   809      809   
   1 1E     1 1   
   1 1    E 1 1   
30060:000000:06002
1    1      1    1
1 F  1G   G 1 F  1
1    1      1    1
800705      407009
1  1          1  1
1  1   A      1  1
8009E       E 8009
1  470000000075  1
1   1        1   1
1   1G     G 1   1
80009   E    80009
1   1        1   1
1   1B    C  1   1
8000:00700700:0009
1   1  1  1  1   1
1F  1  1  1  1 F 1
1   8009  8009   1
80009  1H 1  80009
1   1  1  1  1   1
1   1  1  1  1   1
80709  8009  80709
1 1 1  1  1  1 1 1
1 1 1  1G 1  1 1 1
1 1 1  8009  1 1 1
40:0:005  400:0:05
  1 1        1 1  
  1 1        1 1  
  809 K   J  809  
  1 1        1 1  
  1 1        1 1  
  1 1 E    E 1 1  
  80600700700609  
  1    1  1    1  
  1  F 1H 1G   1  
306000760067000602
1     1    1     1
1E    1    1   E 1
1     1    1     1
8007009 I  8007009
1  1  1    1  1  1
1F 1G 1    1G 1F 1
8005  1    1  4009
1     800009     1
1 E   1    1  E  1
1     1 H  1     1
400;0060000600;005
   1          1   
   1          1   
   400000700005   
         1        
         1        
*
    1 11111 1111111111111 11111     
                                    
    1     1             1     1     
    1     1             1     1     
    1     1             1     1     
    4     1             1     1     
    1     1             1     1     
    1     1             1     1     
    1 11111             1 11111     
                                    
    1     1             1     1     
    3     1             1     1     
    1     1             1     1     
    1     1             1     1     
    1     1             1     1     
    1     1             1     1     
1 111 1 112 1111111111111 111 1 111 
                                    
1     1                     1     1 
1     1                     1     1 
1     1                     1     1 
1     1                     1     1 
1     1                     1     1 
1     1                     1     1 
3 11111 11111 111111111 11111 11113 
                                    
1           1         1           1 
1           1         1           1 
1           1         1           1 
1           1         1           1 
1           1         1           1 
1           1         1           1 
1           1         1           1 
1           1         1           1 
6 11111 1111>         = 11111 11116 
                                    
1     1     1         1     1     1 
1     1     1         1     1     1 
1     1     1 111111111     1     1 
1     1                     1     1 
1 11111     1         1     1 11111 
            1         1             
1     1     1         1     1     1 
1     1     1         1     1     1 
1     1     1 111111111     1     1 
1     1                     1     1 
1 11111     1         1     1 11111 
            1         1             
1     1 11111         1 11111     1 
1                                 1 
1     1     1         1     1     1 
1     1     1         1     1     1 
1     1     1         1     1     1 
1     1     1         1     1     1 
1     2 11114         1 11112     1 
1                                 1 
1 11111     1         1     1 11111 
            1         1             
1     1     1         1     1     1 
1     1     1         1     1     1 
1 11111     1         1     1 11111 
            1         1             
      1     1         1     1       
      1     1         1     1       
      1 11117 111111111 11111       
                                    
      1     1         1     1       
      1     1         1     1       
      1     1         1     1       
      1     1         1     1       
      1 11111         1 11111       
                                    
      1     1         1     1       
      1     1         1     1       
      1     1         1     1       
      1     1         1     1       
1 11114 111 1 111111111 1 111 11111 
                                    
1         1             1         1 
1         1             1         1 
1         1             1         1 
1         1             1         1 
1 111 11111 1 111111111 1 11111 111 
                                    
1   1       1         1       1   1 
1   1       1         1       1   1 
1   1       1         1       1   1 
1   1       1         1       1   1 
1   1       1         1       1   1 
1   1       1         1       1   1 
1 111 1111111         1 1111111 111 
                                    
1   1       1         1       1   1 
1   1       1         1       1   1 
1   1       1         1       1   1 
1   1       1         1       1   1 
1 111       1 111111111       1 111 
                                    
    1       1         1       1     
    1       1         1       1     
    1 1111116         1 1111111     
                                    
            1         1             
            1         1             
    1 1111111         1 1111111     
                                    
    1       1         1       1     
    1       1         1       1     
    1 1 11111 1 11111 1 11111 1     
                                    
      1       1     1       1       
      1       1     1       1       
      1       1     1       1       
      1       1     1       1       
  1 115 1111111     1 1111111 111   
                                    
  1           1     1           1   
  1           1     1           1   
  1           1     1           1   
  1           1     1           1   
  1 111 111 111 11111 111 111 111   
                                    
      1   1             1   1       
      1   1             1   1       
      1   1             1   1       
      1   1             1   1       
      1 111             1 111       
                                    
      1   1             1   1       
      1   1             1   1       
      1   1             1   1       
      1   1             1   1       
1 11114 11= 111111111111> 114 11111 
                                    
1         1             1         1 
1         1             1         1 
1         1             1         1 
1         1             1         1 
1         1             1         1 
1         1             1         1 
1 11116 111             1 116 11111 
                                    
1     1                     1     1 
1     1                     1     1 
1     1                     1     1 
1     1                     1     1 
1 11111                     1 11111 
                                    
1     1 1 11111111111111111 1     1 
1                                 1 
1       1                 1       1 
1       1                 1       1 
1       1                 1       1 
1       1                 1       1 
1 1111117                 1 1111111 
                                    
1       1                 1       1 
1       1                 1       1 
1       1                 1       1 
1       1                 1       1 
5 1111111 11111 11111 11111 1111111 
                                    
1       1     1     1     1       1 
1       1     1     1     1       1 
1       1     1     1     1       1 
1       1     1     1     1       1 
1       1 11111     1 11111       1 
1                                 1 
1 1111111     1     1     1 1111111 
              1     1               
1       1     1     1     1       1 
1       1     1     1     1       1 
1       1     1     1     1       1 
1       1     1     1     1       1 
4 111 111     1 11111     1 111 114 
                                    
1   1   1     1     1     1   1   1 
1   1   1     1     1     1   1   1 
1   1   1     1     1     1   1   1 
1   1   1     1     1     1   1   1 
1   1   1     1 11111     1   1   1 
1   1   1                 1   1   1 
1 111 111 11112     2 11111 111 111 
                                    
    1   1                 1   1     
    1   1                 1   1     
    1   1                 1   1     
    1   1                 1   1     
    1 111                 1 111     
                                    
    1   1                 1   1     
    1   1                 1   1     
    1   1                 1   1     
    1   1                 1   1     
    1   1                 1   1     
    1   1                 1   1     
    3 111 11111 11111 11111 113     
                                    
    1         1     1         1     
    1         1     1         1     
    1         1     1         1     
    1         1     1         1     
1 111 1111111 1 11111 1 1111111 111 
                                    
1           1         1           1 
1           1         1           1 
1           1         1           1 
1           1         1           1 
1           1         1           1 
1           1         1           1 
1 11111 11117         1 11111 11111 
                                    
1     1     1         1     1     1 
1     1     1         1     1     1 
1     1     1         1     1     1 
1     1     1         1     1     1 
1 11111     1         1     1 11111 
            1         1             
1           1 111111111           1 
1                                 1 
1           1         1           1 
1           1         1           1 
1           1         1           1 
1           1         1           1 
1 1111  11111 111111111 1111  11111 
                                    
                                    
                                    
                                    
                                    
                                    
                                    
                                    
                                    
                                    
                                    
*