
3000060:060700702 
1      1   1  1 1 
1      1   1  1 1 
1  3000:0005  1 1 
1  1   1      1 1 
1  1   1      1 1 
8009   8000700:05 
1  1   1   1  1   
80060009   8009   
1      1   1  1   
1      1   1  1   
1   300:0005  1   
1   1  1      1   
1   1  80007009   
80009  1   1  1   
1   1  80005  1   
1   1  1      1   
807060060000006002
1 1              1
8060000002       1
1        400000709
800000002      1 1
1       1      1 1
800007006000070609
1    1       1   1
1  30:0002   1 309
1  1 1   1   1 1 1
1  1 1   1   1 1 1
8005 1   8000:05 1
1    1   1   1   1
80000:000670067009
1    1    1   1  1
1    1    1   1  1
1 3006002 1   4009
1 1     1 8002   1
1 1     1 1  1   1
1 1     1 1  1   1
8060070760:0760009
1    1 1  1 1    1
1    1 1  1 1    1
1    1 1  1 1    1
1    1 1  1 1    1
800005 1  1 400009
1      8009      1
800002 1  1 300009
1    1 1  1 1    1
1    1 1  1 1    1
1    1 1  1 1    1
1    1 1  1 1    1
40000:0:00:0:00075
     1 1  1 1   1 
     1 1  1 1   1 
  3005 1  1 1   1 
  1    1  1 1   1 
  1    1  1 1   1 
  800009  805   1 
  1    1  1     1 
  1    1  8000009 
  1    1  1     1 
  800009  8000009 
  1    1  1     1 
  470075 36070075 
   1  1  1  1  1  
   1  1  8006009  
   1  1  1     1  
   800:005     1  
   1  1        1  
   8006007000009  
   1     1     1  
   8002  1  3009  
   1  1  1  1  1  
   1  400:005  1  
   1     1     1  
   4070006000705  
     1       1    
     1       1    
  300600070006002 
  1      1      1 
  1      1      1 
30600070060000705 
1     1       1   
1     80002   1   
1     1   1   1   
4002  1   1   1   
   1  1   80009   
   1  1   1   1   
300:0060006000:002
1  1          1  1
1  1          1  1
400:00000007076005
   1       1 1    
   1       1 1    
   4002 3005 4002 
      1 1       1 
30700060:00000709 
1 1     1     1 1 
1 1     1     1 1 
1 402   1   305 1 
1   1   1   1   1 
4000:0076700:0005 
    1  1 1  1     
    1  1 1  1     
 3005  1 1  4002  
 1     1 1     1  
 1     1 1     1  
 1     1 1     1  
 407070:06070075  
   1 1 1   1  1   
   1 1 1   4009   
   1 1 1      1   
   1 1 1      1   
   1 1 1      1   
*
1 111111111 111 111 111 11111 111   
                                    
1             1       1     1   1   
1             1       1     1   1   
1             1       1     1   1   
1             1       1     1   1   
1     1 1111111 1111112     1   1   
1                           1   1   
1     1       1             1   1   
1     1       1             1   1   
1     1       1             1   1   
1     1       1             1   1   
1 11111       1 1111111 11111 111   
                                    
1     1       1       1     1       
1     1       1       1     1       
1 11111 1111118       1 11111       
                                    
1             1       1     1       
1             1       1     1       
1             1       1     1       
1             1       1     1       
1       4 11111 1111115     1       
1                           1       
1       1     1             1       
1       1     1             1       
1       1     1 1111111 11111       
1       1                           
1 1111111     1       1     1       
              1       1     1       
1       1     1 1111111     1       
1       1                   1       
1       1     1             1       
1       1     1             1       
1 111 111 11111 1111111111111 11111 
                                    
1   1                             1 
1   1                             1 
1 111 1113111111111               1 
                                  1 
1                 B 11111141111 111 
1                                   
1 111111111111111             1   1 
                              1   1 
1               1             1   1 
1               1             1   1 
1 11111111> 11111 111111112 111 111 
                                    
1         1               1       1 
1         1               1       1 
1     1 111 1111111       1   1 111 
1                         1         
1     1   1       1       1   1   1 
1     1   1       1       1   1   1 
1     1   1       1       1   1   1 
1     1   1       1       1   1   1 
1 11111   1       1 1111111 111   1 
          1                       1 
1         1       1       1       1 
1         1       1       1       1 
1 111111111 1111111 1 11111 1 11111 
                                    
1         1         1       1     1 
1         1         1       1     1 
1         1         1       1     1 
1         1         1       1     1 
1   1 11111 11111   1       1 11111 
1                   1               
1   1           1   1 11111       1 
1   1           1                 1 
1   1           1   1     1       1 
1   1           1   1     1       1 
1   1           1   1     1       1 
1   1           1   1     1       1 
1 111 11114 111 1 111 113 1 1111111 
                                    
1         1   1     1   1         1 
1         1   1     1   1         1 
1         1   1     1   1         1 
1         1   1     1   1         1 
1         1   1     1   1         1 
1         1   1     1   1         1 
1         1   1     1   1         1 
1         1   1     1   1         1 
1 111111111   1     1   1 111111111 
              1     1               
1             1 11111             1 
1                                 1 
1 11111111:   1     1   B 111111111 
              1     1               
1         1   1     1   1         1 
1         1   1     1   1         1 
1         1   1     1   1         1 
1         1   1     1   1         1 
1         1   1     1   1         1 
1         1   1     1   1         1 
1         1   1     1   1         1 
1         1   1     1   1         1 
1 111111111 111 11111 111 1111111 1 
                                    
          1   1     1   1       1   
          1   1     1   1       1   
          1   1     1   1       1   
          1   1     1   1       1   
    1 11111   1     1   1       1   
              1     1   1       1   
    1         1     1   1       1   
    1         1     1   1       1   
    1         1     1   1       1   
    1         1     1   1       1   
    1 111111111     1 111       1   
                                1   
    1         1     1           1   
    1         1     1           1   
    1         1     B 11111111114   
    1         1                     
    1         1     1           1   
    1         1     1           1   
    1 111111111     1 11111111111   
                                    
    1         1     1           1   
    1         1     1           1   
    1 1 11112 1   1 1 115 11111 1   
                                    
      1     1     1     1     1     
      1     1     1     1     1     
      1     1     1 11111 11111     
      1     1                       
      1     1     1           1     
      1     1     1           1     
      1 11111 11117           1     
                              1     
      1     1                 1     
      1     1                 1     
      1 11111 11111 11111111111     
                                    
      1           1           1     
      1           1           1     
      1 11116     1     3 11111     
                  1                 
      1     1     1     1     1     
      1     1     1     1     1     
      1     1 11111 11111     1     
      1                       1     
      1           1           1     
      1           1           1     
      1 111 1111111 1111111 111     
                                    
          1               1         
          1               1         
          1               1         
          1               1         
    1 11111 1111112 1111111 11111   
                                    
    1             1             1   
    1             1             1   
    1             1             1   
    1             1             1   
1 114 1111111 11111 111111111 111   
                                    
1           1               1       
1           1               1       
1           7 1111111       1       
1                           1       
1           1       1       1       
1           1       1       1       
1 11111     1       1       1       
            1       1       1       
      1     1       1 1111111       
      1     1                       
      1     1       1       1       
      1     1       1       1       
1 11111 11111 1111111 1111611 11111 
                                    
1     1                     1     1 
1     1                     1     1 
1     1                     1     1 
1     1                     1     1 
1 11111 111111111111111 111 1 11111 
                                    
      1               1   1         
      1               1   1         
      1               1   1         
      1               1   1         
      1 1111B   2 11111   1 11111   
                                    
            1   1               1   
            1   1               1   
1 111 1111111 111 11111111111 111   
                                    
1   1           1           1   1   
1   1           1           1   1   
1   1           1           1   1   
1   1           1           1   1   
1   1 111       1       1 111   1   
1               1               1   
1       1       1       1       1   
1       1       1       1       1   
1 1111111 11111 1 1 11111 1111111   
                                    
        1     1   1     1           
        1     1   1     1           
        1     1   1     1           
        1     1   1     1           
  4 11111     1   1     1 11115     
              1   1                 
  1           1   1           1     
  1           1   1           1     
  1           1   1           1     
  1           1   1           1     
  1           1   1           1     
  1           1   1           1     
  1 111 111 111 211 111 11111 1     
                                    
      1   1   1       1     1       
      1   1   1       1     1       
      1   1   1       1 11111       
      1   1   1                     
      1   1   1             1       
      1   1   1             1       
      1   1   1             1       
      1   1   1             1       
      1   1   1             1       
      1   1   1             1       