Textures/classic9.bmp
0 0
7 84
0
3070000002        
1 1      1        
1 1      1        
4767070075        
 1 1 1  1         
 1 1 1  1         
 1 1 1  1         
 1 1 1  1         
36760600:002      
1 1     1  1      
1 1     1  1      
80670700:075      
1  1 1  1 1       
1  1 1  1 1       
1  1 1  1 1       
1  1 1  1 1       
80760607676002    
1 1    1 1   1    
1 1    1 1   1    
4760000:0:0709    
 1     1 1 1 1    
 1     1 1 1 1    
36000076060609    
1     1      1    
1     1      1    
1     1      1    
800000:0000009    
1     1      1    
1     1      1    
80700060007006002 
1 1       1     1 
4060007070:000705 
      1 1 1   1   
      1 1 1   1   
     36767600062  
     1 1 1     1  
     1 1 1     1  
     47606000709  
      1      1 1  
 30070:0700006062 
 1  1 1 1       1 
 1  1 1 1       1 
 8006060:00000009 
 1      1       1 
 8070707600000009 
 1 1 1 1        1 
 1 1 1 1        1 
 1 1 1 1        1 
 4767606000707075 
  1 1      1 1 1  
  1 1      1 1 1  
  1 1      1 1 1  
 36060000706060602
 1       1       1
 1       1       1
 40000707670070075
      1 1 1  1  1 
      1 1 1  1  1 
      80:0:0060062
      1 1 1      1
      1 1 1      1
      1 1 1      1
      1 1 1      1
      806767000709
      1  1 1   1 1
      1  1 1   1 1
      1  1 1   1 1
   300600:0:070609
   1     1 1 1   1
   800000676060009
   1      1      1
   1      1      1
   1      1      1
300600007060000009
1       1        1
1       1        1
1       1        1
1       1        1
4000000;6000000005
       1          
       1          
       1          
       1          
       1          
*
1 111 1111611111111                 
                                    
1   1             1                 
1   1             1                 
1   1             1                 
1   1             1                 
1 1 1 1 111 11111 1                 
                                    
  1   1   1     1                   
  1   1   1     1                   
  1   1   1     1                   
  1   1   1     1                   
  1   1   1     1                   
  1   1   1     1                   
  1   1   1     1                   
  1   1   1     1                   
1 6 1 1 111 11111 11111             
                                    
1   1           1     1             
1   1           1     1             
1   1           1     1             
1   1           1     1             
1 111 1 111 11111 211 1             
                                    
1     1   1     1   1               
1     1   1     1   1               
1     1   1     1   1               
1     1   1     1   1               
1     1   1     1   1               
1     1   1     1   1               
1     1   1     1   1               
1     1   1     1   1               
1 411 1 111 111 1 1 1 11111         
                                    
1   1         1   1       1         
1   1         1   1       1         
1   1         1   1       1         
1   1         1   1       1         
1 1 1 111111111 111 >11 111         
                                    
  1           1   1   1   1         
  1           1   1   1   1         
  1           1   1   1   1         
  1           1   1   1   1         
1 1 111111111 5 111 111 111         
                                    
1           1             1         
1           1             1         
1           1             1         
1           1             1         
1           1             1         
1           1             1         
1 111111:1111 1111111111111         
                                    
1           1             1         
1           1             1         
1           1             1         
1           1             1         
1 111 1111511 1111111 11111 11111   
                                    
1   1               1           1   
1   1               1           1   
1 111 1111111 111 111 1111111 111   
                                    
            1   1   1       1       
            1   1   1       1       
            1   1   1       1       
            1   1   1       1       
          1 1 1 1 1 4 1111111 1     
                                    
          1   1   1           1     
          1   1   1           1     
          1   1   1           1     
          1   1   1           1     
          1 1 1 111 4111111 111     
                                    
            1             1   1     
            1             1   1     
  1 11112 111 111 111111111 111 1   
                                    
  1     1   1   1               1   
  1     1   1   1               1   
  1     1   1   1               1   
  1     1   1   1               1   
  1 11111 411 111 111111111111111   
                                    
  1             1               1   
  1             1               1   
  1 117 111 111 1 111111111111111   
                                    
  1   1   1   1                 1   
  1   1   1   1                 1   
  1   1   1   1                 1   
  1   1   1   1                 1   
  1   1   1   1                 1   
  1   1   1   1                 1   
  1 3 1 1 1 111 1111111 111 111 1   
                                    
    1   1             1   1   1     
    1   1             1   1   1     
    1   1             1   1   1     
    1   1             1   1   1     
    1   1             1   1   1     
    1   1             1   1   1     
  1 1 11< 111111111 111 111 111 111 
                                    
  1               1               1 
  1               1               1 
  1               1               1 
  1               1               1 
  1 111111111 111 1 1 11111 11611 1 
                                    
            1   1   1     1     1   
            1   1   1     1     1   
            1   1   1     1     1   
            1   1   1     1     1   
            1 111 111 11211 11111 1 
                                    
            1   1   1             1 
            1   1   1             1 
            1   1   1             1 
            1   1   1             1 
            1   1   1             1 
            1   1   1             1 
            1   1   1             1 
            1   1   1             1 
            1 115 1 1 1 1111111 111 
                                    
            1     1   1       1   1 
            1     1   1       1   1 
            1     1   1       1   1 
            1     1   1       1   1 
            1     1   1       1   1 
            1     1   1       1   1 
      1 11111 11111 111 111 111 111 
                                    
      1           1   1   1       1 
      1           1   1   1       1 
      1 11511111111 1 1 111 1111111 
                                    
      1             1             1 
      1             1             1 
      1             1             1 
      1             1             1 
      1             1             1 
      1             1             1 
1 11111 111111111 111 1111411111111 
                                    
1               1                 1 
1               1                 1 
1               1                 1 
1               1                 1 
1               1                 1 
1               1                 1 
1               1                 1 
1               1                 1 
1 111111111111111 11111111111111111 
                                    
                                    
                                    
                                    
                                    
                                    
                                    
                                    
                                    
                                    
                                    
*