Textures/desert1.bmp
9 0
9 120
0
    30000700002   
    1    1    1   
    40000:00005   
         1        
         1 A      
3000000009        
1        1        
1   B    1        
800000000:00070002
1        1   1   1
1        1   1 C 1
4000700009   1   1
    1    1   80009
    1 A  1   1   1
    1    1   1   1
    80000:000:0005
D   1    1   1    
    1    1 B 1    
    1    1   1    
 30060000:00060002
 1       1       1
 1       1       1
 1 300000:000002 1
 1 1     1     1 1
 809     1   A 809
 1 1 C   1     1 1
 1 1     1     1 1
 1 400000:000005 1
 1       1       1
 40070000:00007005
    1    1    1   
  B 1    1 B  1   
    1    1    1   
 30060700:00006002
 1    1  1       1
 1    1  1B   A  1
 80000:00602     1
 1    1    1     1
 1 B  8002 4007009
 1    1  1    1  1
 1    1  1    1  1
 40070600:07006009
    1    1 1     1
    1 A  1 1  C  1
    1    1 1     1
D   400009 8000005
         1 1      
         1 1      
3000070009 8000002
1    1   1 1     1
1C   1 B 405   A 1
1    1           1
407006007000000705
  1     1      1  
  1 A   1   B  1  
  1     1      1  
306000706007000602
1     1    1     1
1     1 C  1     1
1     1    1     1
470700600706700075
 1 1     1  1   1 
 1 4070005  40705 
 1   1        1   
 1  360700007062  
 4009  1    1  1  
    1  1 A  1  1  
    800607006075  
    1    1    1   
D   1 B  1 C  1   
307060707600075   
1 1   1 1    1    
1 1   1 1 A  8002 
1 80009 800009  1 
1 1   1 1    8005 
476000:0607009    
 1    1   1  1    
 8000060076709    
 1       1 1 9D   
 1       1 1 80002
 1D    B 1 1 1   1
 407000009 409   1
   1     1   1   1
   470000:0009   1
    1    1   80009
    1    1   1   1
3000:000060009   1
1   1        1 C 1
1 B 1   A    1   1
407067000007060075
  1  1     1    1 
  1  1 C   1    1 
  470607000607009 
   1   1     1  1 
   1   1 B   1  1 
   80076000706075 
   1  1    1   1  
   1C 1 A  1   1  
   1  1    1   1  
   4706070060709  
    1   1    1 1  
    1   1 B  1 1  
    1   1    809  
  306070600705 1  
  1   1    1   1  
  1   1    1   1  
  80009    80009  
  1   1D   1   1  
  1B  407005 C 1  
  1     1      1  
  1     1      1  
  800000:0700009  
  1     1 1    1  
  1  A  1 1  B 1  
  1  3005 4002 1  
  4009       805  
     4000;0005    
         1        
         1        
         1        
         1        
*
        1 111111111 111111111       
                                    
        1         1         1       
        1         1         1       
        1 111111111 111111111       
                                    
                  1                 
                  1                 
                  1                 
                  1                 
1 11111111111111111                 
                                    
1                 1                 
1                 1                 
1                 1                 
1                 1                 
1 11111111111111111 1111111 1111116 
                                    
1                 1       1       1 
1                 1       1       1 
1                 1       1       1 
1                 1       1       1 
1 1111111 111111111       1       1 
                          1       1 
        1         1       1 1111111 
        1         1                 
        1         1       1       1 
        1         1       1       1 
        1         1       1       1 
        1         1       1       1 
        1 111111112 1111111 1111111 
                                    
        1         1       1         
        1         1       1         
        1         1       1         
        1         1       1         
        1         1       1         
        1         1       1         
  4 11111 111111111 1111111 1111114 
                                    
  1               1               1 
  1               1               1 
  1               1               1 
  1               1               1 
  1   5 11111111111 11111111115   1 
  1                               1 
  1   1           1           1   1 
  1   1           1           1   1 
  = 111           1           1 11; 
                  1                 
  1   1           1           1   1 
  1   1           1           1   1 
  1   1           1           1   1 
  1   1           1           1   1 
  1   5 11111111117 11111111115   1 
  1                               1 
  1               1               1 
  1               1               1 
  4 11111 111111111 111111111 11114 
                                    
        1         1         1       
        1         1         1       
        1         1         1       
        1         1         1       
        1         1         1       
        1         1         1       
  1 11111 111 11113 111111111 11111 
                                    
  1         1     1               1 
  1         1     1               1 
  1         1     1               1 
  1         1     1               1 
  2 111111111 11111 111           1 
                                  1 
  1         1         1           1 
  1         1         1           1 
  1         1 11111   1 11111 11111 
  1                                 
  1         1     1         1     1 
  1         1     1         1     1 
  1         1     1         1     1 
  1         1     1         1     1 
  4 11111 111 11111 111 11111 11114 
                                    
        1         1   1           1 
        1         1   1           1 
        1         1   1           1 
        1         1   1           1 
        1         1   1           1 
        1         1   1           1 
        1 11111111;   1 11111111111 
                                    
                  1   1             
                  1   1             
                  1   1             
                  1   1             
1 111111111 1111111   1 11111111116 
                                    
1         1       1   1           1 
1         1       1   1           1 
1         1       1 111           1 
1         1                       1 
1         1                       1 
1         1                       1 
6 111 11111 11111 1111111111111 111 
                                    
    1           1             1     
    1           1             1     
    1           1             1     
    1           1             1     
    1           1             1     
    1           1             1     
1 111 1111111 111 11111 111111= 111 
                                    
1           1         1           1 
1           1         1           1 
1           1         1           1 
1           1         1           1 
1           1         1           1 
1           1         1           1 
1 1 111 11111 11111 111 1 1111111 1 
                                    
  1   1           1     1       1   
  1   1           1     1       1   
  1   5 111 1111111     1 111 115   
  1                                 
  1       1                 1       
  1       1                 1       
  1     1 1 111 111111111 111 :     
  1                                 
  2 11111     1         1     1     
              1         1     1     
        1     1         1     1     
        1     1         1     1     
        1 11111 118 11111 111 1     
                                    
        1         1         1       
        1         1         1       
        1         1         1       
        1         1         1       
1 111 111 111 111 1 1111111 1       
                                    
1   1       1   1         1         
1   1       1   1         1         
1   1       1   1         1 11115   
1   1       1   1                   
1   1 1111111   1 111111111     1   
1                               1   
1   1       1   1         1 11111   
1   1       1   1                   
6 1 1 1111113 111 111 11111         
                                    
  1         1       1     1         
  1         1       1     1         
  1 111111111 11111 1 1 111         
                                    
  1               1   1   1         
  1               1   1             
  1               1   1   1 1111114 
  1               1   1             
  1               1   1   1       1 
  1               1   1   1       1 
  ; 111 11111111111   1 111       1 
                                  1 
      1           1       1       1 
      1           1       1       1 
      1 1 111111111 111111=       1 
                                  1 
        1         1       1 1111111 
        1         1                 
        1         1       1       1 
        1         1       1       1 
1 1111111 111111111 1111111       1 
                                  1 
1       1                 1       1 
1       1                 1       1 
1       1                 1       1 
1       1                 1       1 
4 111 111 1 11111111111 111 11111 5 
                                    
    1     1           1         1   
    1     1           1         1   
    1     1           1         1   
    1     1           1         1   
    1 1 111 111 1111111 112 11111   
                                    
      1       1           1     1   
      1       1           1     1   
      1       1           1     1   
      1       1           1     1   
      6 11111 1 1111111 111 111 4   
                                    
      1     1         1       1     
      1     1         1       1     
      1     1         1       1     
      1     1         1       1     
      1     1         1       1     
      1     1         1       1     
      1 1 111 111 11111 111 111     
                                    
        1       1         1   1     
        1       1         1   1     
        1       1         1   1     
        1       1         1   1     
        1       1         1 111     
        1       1                   
    7 111 111 111 11111 111   1     
                              1     
    1       1         1       1     
    1       1         1       1     
    1       1         1       1     
    1       1         1       1     
    1 1111111         1 1111111     
                                    
    1       1         1       1     
    1       1         1       1     
    1       1 111 11111       1     
    1                         1     
    1           1             1     
    1           1             1     
    1           1             1     
    1           1             1     
    1 11111111111 111 111111116     
                                    
    1           1   1         1     
    1           1   1         1     
    1           1   1         1     
    1           1   1         1     
    1     1 11114   4 11111   1     
    1                         1     
    1 11111               1 111     
                                    
          1 111111  1111111         
                                    
                                    
                                    
                                    
                                    
                                    
                                    
                                    
                                    
*