Textures/desert2.bmp
7 0
7 117
0
      3002        
   3005  4002     
   1        1     
   1 A   B  1     
   1        1     
   4700000075     
    1      1      
30009      80002  
1   1      1   1  
80005 D    40009  
1              1  
8000002  3000009  
1     1  1     1  
1     1  1 B   1  
802   8009   309  
1 1C  1  1   1 1  
1 1   1  1   1 1  
1 80005  40009 1  
1 1          1 1  
809          809  
1 40002  30005 1  
1     1  1     1  
1     1  1     1  
1     8009     1  
1 D   1  1D    1  
1  3009A 8002  1  
1  1  1  1  1  1  
8009  1  1  8009  
1  1  1  1B 1  1  
1  4076006705  1  
1    1    1    1  
800709    807009  
1  1 1    1 1  1  
1  1 1D   1 1  1  
1  1 1    1 1  1  
1  475 C  475  1  
1   1      1   1  
40705      40705  
  1      A   1    
  1  B       1    
 36070700707062   
 1  1 1  1 1  1   
 1  1 1  1 1  1   
362 1 1B 1 1 362  
1 80609  80609 1  
475   1  1   475  
 1    1  1C   1   
 47070:00:07075   
  1 1 1  1 1 1    
30609 1  1 80602  
1   40:00:05   1  
1     1  1     1  
1     1  1     1  
1 30705  40702 1  
1 1 1      1 1 1  
1 1 1      1 1 1  
47609      80675  
 1  1 D    1  1   
 1  1      1B 1   
 400:02  30:005   
    1 8009 1      
 300609  806002   
 1    1  1    1   
 1 B  1A 1    1   
 402  1  1  305   
   8009  8009     
   1  1  1  1C    
3009  1  1  8002  
1  1  8009  1  1  
8005  1  1  4009  
1     1  1     1  
1   A 1  1     1  
4700705  4070075  
 1  1      1  1   
35  1  C   1  42  
1   1      1   1  
8000:002300:0009  
1   1  11  1   1  
80009  11  80009  
1   80754709   1  
1 B 1 1  1 1   1  
40705 8009 40705  
  1   1  1   1    
  1   1A 1   1    
  1   1  1 B 1    
  470760067075    
   1 1    1 1     
   1 1    1 1     
   1 1    1 1     
   1 1D   1 1     
   1 800009 1     
   1 1    1 1     
   40:0000:05     
     1    1       
     1A   1       
300009    800002  
1    1    1    1  
1    1    1    1  
400709 B  807005  
   1 1    1 1     
300:0:0000:0:002  
1  1 1    1 1  1  
1  1 1  C 1 1  1  
1  1 470075 1A 1  
1  1  1  1  1  1  
1  1  1  1  1  1  
8006009  8006009  
1     1  1     1  
1 B   1  1     1  
4000075  4700005  
     1    1       
     1    1 C     
 A   1    1       
     1D   1       
     40;005       
       1          
       1          
       1          
*
            1 11111                 
                                    
      1 11111     1 11111           
                                    
      1                 1           
      1                 1           
      1                 1           
      1                 1           
      1                 1           
      1                 1           
      1 1 1111111111111 1           
                                    
        1             1             
        1             1             
1 1111111             1 1111111     
                                    
1       1             1       1     
1       1             1       1     
1 1111116             6 1111111     
                                    
1                             1     
1                             1     
1 11111111111     1 11111111111     
                                    
1           1     1           1     
1           1     1           1     
1           1     1           1     
1           1     1           1     
4 111       1 11111       1 114     
                                    
1   1       1     1       1   1     
1   1       1     1       1   1     
1   1       1     1       1   1     
1   1       1     1       1   1     
1   2 1111111     1 1111112   1     
1                             1     
1   1                     1   1     
1   1                     1   1     
1 111                     1 111     
                                    
1   6 1111118     7 1111116   1     
1                             1     
1           1     1           1     
1           1     1           1     
1           1     1           1     
1           1     1           1     
1           1 11111           1     
1                             1     
1           1     1           1     
1           1     1           1     
1     6 11111     1 11116     1     
1                             1     
1     1     1     1     1     1     
1     1     1     1     1     1     
1 11111     1     1     1 11111     
            1     1                 
1     1     1     1     1     1     
1     1     1     1     1     1     
1     1 111 1 11111 1 111     1     
1                             1     
1         1         1         1     
1         1         1         1     
1 11111 111         1 111 11111     
                                    
1     1   1         1   1     1     
1     1   1         1   1     1     
1     1   1         1   1     1     
1     1   1         1   1     1     
1     1   1         1   1     1     
1     1   1         1   1     1     
1     1 5 1         1 5 1     1     
1                             1     
1       1             1       1     
1       1             1       1     
: 111 111             1 111 11:     
                                    
    1                     1         
    1                     1         
    1                     1         
    1                     1         
  1 1 111 111 11111 111 111 1       
                                    
  1     1   1     1   1     1       
  1     1   1     1   1     1       
  1     1   1     1   1     1       
  1     1   1     1   1     1       
> 1 7   1   1     1   1   = 1 8     
        1   1     1   1             
1   1 111 111     1 111 111   1     
1                             1     
4 1 6       1     1       6 1 4     
            1     1                 
  1         1     1         1       
  1         1     1         1       
  1 1 111 111 11111 111 111 1       
                                    
    1   1   1     1   1   1         
    1   1   1     1   1   1         
3 111 111   1     1   1 111 113     
            1     1                 
1       1 111 11111 111       1     
1                             1     
1           1     1           1     
1           1     1           1     
1           1     1           1     
1           1     1           1     
1   5 111 111     1 111 115   1     
1                             1     
1   1   1             1   1   1     
1   1   1             1   1   1     
1   1   1             1   1   1     
1   1   1             1   1   1     
1 1 1 111             1 111 1 1     
                                    
  1     1             1     1       
  1     1             1     1       
  1     1             1     1       
  1     1             1     1       
  1 11111 111     1 111 11111       
                                    
        1   1 11111   1             
        1             1             
  4 11111 111     1 111 11114       
                                    
  1         1     1         1       
  1         1     1         1       
  1         1     1         1       
  1         1     1         1       
  1 111     1     1     1 111       
            1     1                 
      1 11112     2 11111           
                                    
      1     1     1     1           
      1     1     1     1           
3 11111     1     1     1 11113     
            1     1                 
1     1     1 11111     1     1     
1     1                 1     1     
1 11111     1     1     1 11111     
            1     1                 
1           1     1           1     
1           1     1           1     
1           1     1           1     
1           1     1           1     
1 1 11111 111     1 111 11111 1     
                                    
  1     1             1     1       
  1     1             1     1       
1 1     1             1     1 1     
        1             1             
1       1             1       1     
1       1             1       1     
7 1111114 11111 1 11114 1111117     
                                    
1       1     1 1     1       1     
1       1     1 1     1       1     
1 1111111     1 1     1 1111111     
              1 1                   
1       6 111 1 1 1 116       1     
1                             1     
1       1   1     1   1       1     
1       1   1     1   1       1     
1 11> 111   1 11111   1 11= 111     
                                    
    1       1     1       1         
    1       1     1       1         
    1       1     1       1         
    1       1     1       1         
    1       1     1       1         
    1       1     1       1         
    1 1 115 1 11111 4 112 1         
                                    
      1   1         1   1           
      1   1         1   1           
      1   1         1   1           
      1   1         1   1           
      1   1         1   1           
      1   1         1   1           
      1   1         1   1           
      1   1         1   1           
      1   4 111181115   1           
      1                 1           
      1   1         1   1           
      1   1         1   1           
      2 111 111111111 111           
                                    
          1         1               
          1         1               
          1         1               
          1         1               
5 111111111         1 111111114     
                                    
1         1         1         1     
1         1         1         1     
1         1         1         1     
1         1         1         1     
4 11111 111         1 111 11115     
                                    
      1   1         1   1           
      1   1         1   1           
1 11111 111 111111111 111 11111     
                                    
1     1   1         1   1     1     
1     1   1         1   1     1     
1     1   1         1   1     1     
1     1   1         1   1     1     
1     1   1 1 11111 1   1     1     
1     1                 1     1     
1     1     1     1     1     1     
1     1     1     1     1     1     
1     1     1     1     1     1     
1     1     1     1     1     1     
1 11111 11111     1 11111 11111     
                                    
1           1     1           1     
1           1     1           1     
1           1     1           1     
1           1     1           1     
6 111111111 1     1 1 111111116     
                                    
          1         1               
          1         1               
          1         1               
          1         1               
          1         1               
          1         1               
          1         1               
          1         1               
          1 11  11111               
                                    
                                    
                                    
                                    
                                    
                                    
                                    
*