Textures/grave1.bmp
9 3
9 103
0
      3007002     
    G 1  1  1G    
      1  1  1     
   300:00:00:002  
   1  1  1  1  1  
   1J 1I 1I 1H 1  
   1  4706075  1  
   1   1   1   1  
   1   1 L 1   1  
 30:02 80009 30:02
 1 1 1 1   1 1 1 1
 1 1 1 1   1 1 1 1
 80:09 1 K 1 80:09
 1 1 476000675 1 1
 1 1  1     1  1 1
 1 4706007006075 1
 1  1    1    1  1
 40067000:00076005
     1   1   1    
     1G  1 G 1    
     1   1   1    
 30006700600760002
 1    1     1    1
 1  H 1     1I   1
 1  30600700602  1
 8009    1    8009
 1  1    1K   1  1
 1K 1L I 1    1J 1
 4705  30:02  4075
  1    1 1 1    1 
  4007060:0607005 
     1   1   1    
     1   1   1    
 3070:000:000:0702
 1 1 1   1   1 1 1
 805 1   1   1 409
 1   1   1   1   1
 1 G 807060709G  1
 80009 1   1 80009
 1   1 1 L 1 1   1
 802 475   475 309
 1 1  1     1  1 1
 40:009     800:05
   1  1     1  1  
   1I 1  J  1I 1  
   4706700076075  
    1  1   1  1   
    1  1   1  1   
    8009   8009   
    1  80009  1   
    1  1   1  1   
 3009G 1   1G 8002
 1  1  1   1  1  1
 1  1  40705  1  1
 1  802  1  309  1
 4075 1I 1L 1 4705
   1  1  1  1  1  
   407600:006705  
     1   1   1    
     4070:0705    
       1 1 1      
       1 1 1      
   G 3060:0602G   
     1   1   1    
     1 30:02 1    
     1 1 1 1 1    
     80:0:0:09    
     1 1 1 1 1    
     1 40:05 1    
     1   1   1    
     4070:0705    
   G   1 1 1  G   
       1 1 1      
      360:062     
      1  1  1     
   3009H 1  8002  
   1  800:009  1  
   1  1  1  1  1  
   1K 1  1  1L 1  
   800:00600:009  
   1  1     1  1  
   1  1     1  1  
   1  8007009  1  
 309  1  1  1  802
 1 1I 800:009J 1 1
 1 1  1  1  1  1 1
 806005  1  400609
 1       1       1
 40070070:07007005
    1  1 1 1  1   
    1  1 1 1  1   
    1  1 1 1  1   
 3009  80609  8002
 1  1  1   1  1  1
 8009  1   1  8009
 1  4005   4005  1
 1G            G 1
 1       J       1
 40000000;00000005
         1        
         1        
         1        
         1        
         1        
*
            4 11111 11114           
                                    
            1     1     1           
            1     1     1           
            1     1     1           
            1     1     1           
      1 11111 11111 11111 11111     
                                    
      1     1     1     1     1     
      1     1     1     1     1     
      1     1     1     1     1     
      1     1     1     1     1     
      1     1 1 111 111 1     1     
      1                       1     
      1       1       1       1     
      1       1       1       1     
      1       1       1       1     
      1       1       1       1     
  = 111 111   1 1111111   1 111 11= 
                                    
  1   1   1   1       1   1   1   1 
  1   1   1   1       1   1   1   1 
  1   1   1   1       1   1   1   1 
  1   1   1   1       1   1   1   1 
  1 111 111   1       1   1 111 111 
              1       1             
  1   1   3 1 1 1111111 1 3   1   1 
  1   1                       1   1 
  1   1     1           1     1   1 
  1   1     1           1     1   1 
  1   5 1 111 11111 11111 111 5   1 
  1                               1 
  1     1         1         1     1 
  1     1         1         1     1 
  4 11111 1 1111118 1111111 1 11114 
                                    
          1       1       1         
          1       1       1         
          1       1       1         
          1       1       1         
          1       1       1         
          1       1       1         
  2 1111116 1 11111 11111 6 1111112 
                                    
  1         1           1         1 
  1         1           1         1 
  1         1           1         1 
  1         1           1         1 
  1     1 111 1111< 11111 111     1 
  1                               1 
  1 11111         1         1 11111 
                  1                 
  1     1         1         1     1 
  1     1         1         1     1 
  1     1         1         1     1 
  1     1         1         1     1 
  1 1 111     1 111 111     5 111 1 
                                    
    1         1   1   1         1   
    1         1   1   1         1   
    1 11111 111 11> 111 111 11111   
                                    
          1       1       1         
          1       1       1         
          1       1       1         
          1       1       1         
  6 111 114 1111111 1111114 111 116 
                                    
  1   1   1       1       1   1   1 
  1   1   1       1       1   1   1 
  1 111   1       1       1   1 111 
          1       1       1         
  1       1       1       1       1 
  1       1       1       1       1 
  1       1 111 111 111 111       1 
  1                               1 
  1 1111111   1       1   1 1111111 
              1       1             
  1       1   1       1   1       1 
  1       1   1       1   1       1 
  1 111   1 1 1       1 1 1   1 111 
                                    
  1   1     1           1     1   1 
  1   1     1           1     1   1 
  5 111 11111           1 11111 115 
                                    
      1     1           1     1     
      1     1           1     1     
      1     1           1     1     
      1     1           1     1     
      1 1 111 1 1111111 1 111 1     
                                    
        1     1       1     1       
        1     1       1     1       
        1     1       1     1       
        1     1       1     1       
        1 11111       1 11111       
                                    
        1     1 1111111     1       
        1                   1       
        1     1       1     1       
        1     1       1     1       
  5 11111     1       1     1 11115 
              1       1             
  1     1     1       1     1     1 
  1     1     1       1     1     1 
  1     1     1 111 111     1     1 
  1     1                   1     1 
  1     1 111     1     1 111     1 
  1               1               1 
  1 111 1   1     1     1   1 1 111 
            1     1     1           
      1     1     1     1     1     
      1     1     1     1     1     
      1 111 1 11112 11111 1 111     
                                    
          1       1       1         
          1       1       1         
          1 111 111 111 111         
                                    
              1   1   1             
              1   1   1             
              1   1   1             
              1   1   1             
          4 111 111 111 115         
                                    
          1       1       1         
          1       1       1         
          1   1 111 111   1         
          1               1         
          1   1   4   1   1         
          1   1   1   1   1         
          1 111 518 151 111         
                                    
          1   1   1   1   1         
          1   1   4   1   1         
          1   1 111 111   1         
          1               1         
          1       1       1         
          1       1       1         
          5 111 111 111 114         
                                    
              1   1   1             
              1   1   1             
              1   1   1             
              1   1   1             
            1 1 111 111 1           
                                    
            1     1     1           
            1     1     1           
      1 11111     1     1 11111     
                  1                 
      1     1 11111 11111     1     
      1                       1     
      1     1     1     1     1     
      1     1     1     1     1     
      1     1     1     1     1     
      1     1     1     1     1     
      1 11111 11111 11111 11111     
                                    
      1     1           1     1     
      1     1           1     1     
      1     1           1     1     
      1     1           1     1     
      1     1 11115 11111     1     
      1                       1     
  1 111     1     1     1     1 111 
            1     1     1           
  1   1     1 11111 11111     1   1 
  1   1                       1   1 
  1   1     1     1     1     1   1 
  <   1     1     1     1     1   < 
  1 111 11111     1     1 11111 111 
                  1                 
  1               1               1 
  1               1               1 
  1 11111 11111 111 111 11111 11111 
                                    
        1     1   1   1     1       
        1     1   1   1     1       
        1     1   1   1     1       
        1     1   1   1     1       
        1     1   1   1     1       
        1     1   1   1     1       
  3 11111     6 111 116     1 11113 
                                    
  1     1     1       1     1     1 
  1     1     1       1     1     1 
  1 11111     1       1     1 11111 
              1       1             
  1     1 11111       1 11111     1 
  1                               1 
  1                               1 
  1                               1 
  1                               1 
  1                               1 
  1 11111111111111  111111111111111 
                                    
                                    
                                    
                                    
                                    
                                    
                                    
                                    
                                    
                                    
                                    
*