Textures/garden3.bmp
3 0
9 123
0
  30700007000002  
  1 1    1     1  
  1 1  A 1B  C 1  
  1 1    1     1  
  1 1  30:000009  
  1 1  1 1     1  
  406009 1  D  1  
       1 1     1  
30000009 8007009  
1      1 1  1  1  
1Y Z [ 1 1  1  1  
800002 1 1  1  402
1    1 1 1H 1    1
1    1 1 1  1    1
1 A  1 1 1  400009
1    40609       1
1        1G    E 1
800007000600700009
1    1      1    1
1S U 1C   B 1S U 1
1    80007009    1
1M O 1   1  1M O 1
1    1   1  800005
1    80009E 1     
400005   1  1     
         1  1     
         1  1     
 300070009H 8002  
 1   1   1  1  1  
 1 B 1   1  1X 1  
 1   1 J 1  1  1  
 1   1   1F 1W 1  
 1   80006005  1  
 1   1       V 1  
 800060007000705  
 1       1   1    
 1   I   1 K 1    
 1       1   1    
 40070000:00060002
    1    1       1
    1 D  1B C  B 1
    1    1       1
    80070600007009
    1  1      1  1
30009  1      1  1
1   1  1Y Z [ 1  1
8000:00:000000:009
1   1  1      1  1
1   1C 1Y Z [ 1D 1
80705  1      8009
1 1    40007005  1
1 1        1   \ 1
1 4007000006007005
1    1        1   
40000:00000000:002
     1        1  1
     1        1  1
     1        1  1
300006000070009  1
1         1   1  1
1B  C   B 1D  1  1
1         1   1  1
4007000700:000:005
   1   1  1   1   
   1 F 1  1E  1   
3009   4005   8002
1  1          1  1
1  470000000075  1
1   1        1   1
1   1        1   1
1   1        1   1
4000:00070000:0005
    1   1    1    
    1 K 1    1    
30005   800009    
1       1    1    
1J      1Y [ 1    
40700070600009    
  1   1      1    
  1   1      1    
  1   1H   G 1    
  8000:0070005    
  1   1  1        
  1   1  1 I      
  1 306005        
  1 1             
  1 1             
  8060070000700002
  1    1    1    1
  4000060070607009
          1   1  1
          1   1J 1
          40706009
            1    1
            1Y [ 1
            800009
            1    1
    300700009Y [ 1
    1  1    800705
    1C 1B D 1  1  
    1  1    1C 1  
 300600:00005  1  
 1     1       1  
 8007009C      1  
 1  1  1     F 1  
 1  1  400070705  
 1  1      1 1    
 1  1H G E 1 1    
 400:0000005 1    
    1        1    
    8000070005    
    1    1        
    1Y [ 1        
    80000:0000002 
    1    1      1 
    1 J  1  I   1 
    4070060007005 
      1      1    
      1Y Z [ 1    
      400;0005    
         1        
         1        
         1        
         1        
*
    1 111 111111111 11111111111     
                                    
    1   1         1           1     
    1   1         1           1     
    1   1         1           1     
    1   1         1           1     
    1   1         1           1     
    1   1         1           1     
    1   1     1 111 11111111111     
    1   1                           
    1   1     1   1           1     
    1   1     1   1           1     
    1 111111111   1           1     
              4   1           2     
              1   1           1     
              1   1           1     
1 1111111111111   1 11111 11111     
                                    
1             1   1     1     1     
1             1   1     1     1     
1             1   1     1     1     
1             1   1     1     1     
1 111111111   1   1     1     1 111 
              1   1     1           
1         1   1   1     1         1 
1         1   1   1     1         1 
1         1   1   1     1         1 
6         1   1   1     1         1 
1         1   1   1     1 111111111 
1         1   1   1                 
1         1 111 111               1 
1                                 1 
1                 1               1 
1                 1               1 
1 111111111 111111> 11111 111111111 
                                    
1         1             1         1 
1         1             1         1 
1         1             1         1 
1         1             1         4 
1         1 1111111 11111         1 
1                                 1 
3         1       1     1         1 
1         1       1     1         1 
1         1       1     1 111111111 
1         1       1                 
1         1 1111111     1           
1                       1           
1 111111111       1     1           
                  1     1           
                  1     1           
                  1     1           
                  1     1           
                  1     1           
  1 1111111 111111:     1 11111     
                                    
  1       1       1     1     1     
  1       1       1     1     1     
  1       1       1     1     1     
  1       1       1     1     1     
  1       1       5     1     1     
  1       1       1     1     1     
  1       1       1     1     1     
  1       1       1     1     1     
  1       1 1111111 11111     1     
  1                           1     
  1       1                   1     
  1       1                   1     
  = 1111111 1111111 1111111 111     
                                    
  1               1       1         
  1               1       1         
  1               1       1         
  1               1       1         
  1               1       1         
  1               1       1         
  1 11111 111111113 1111111 1111111 
                                    
        1         1               1 
        1         1               1 
        1         1               1 
        1         1               1 
        1         1               1 
        1         1               1 
        1 11111 111 111111111 11111 
                                    
        1     1             1     1 
        1     1             1     1 
1 1111111     1             1     1 
              1             1     1 
1       1     1             1     1 
1       1     1             1     1 
5 1111111 11111 1111118111111 11111 
                                    
1       1     1             1     1 
1       1     1             1     1 
1       1     1             1     1 
1       1     1             1     1 
1 111 111     1             1 11111 
              1                     
1   1         > 1111111 11111     1 
1   1                             1 
1   1                 1           6 
1   1                 1           1 
2   1 11111 11111111111 11111 11111 
1                                   
1         1                 1       
1         1                 1       
1 111111111 11111111111111112 11111 
                                    
          1                 1     1 
          1                 1     1 
          1                 1     1 
          1                 1     1 
          1                 1     1 
          1                 1     1 
1 111111111 111113111 1111111     1 
                                  1 
1                   1       1     1 
1                   1       1     1 
1                   1       1     1 
1                   1       1     1 
1                   1       1     1 
1                   1       1     1 
1 11111 1111111 11111 1111111 11111 
                                    
      1       1     1       1       
      1       1     1       1       
      1       1     1       1       
      1       1     1       1       
1 11111       4 11713       1 11111 
                                    
1     1                     1     1 
1     1                     1     1 
1     1 1 11111111111111111 1     1 
1                                 1 
1       1                 1       1 
1       1                 1       1 
1       1                 1       1 
1       1                 1       1 
1       1                 1       1 
1       1                 1       1 
1 1111111 1111112 111111111 1111111 
                                    
        1       1         1         
        1       1         1         
        1       1         1         
        1       1         1         
1 1111111       1 111111111         
                                    
1               1         1         
1               1         1         
1               1         1         
1               1         1         
1 111 1111111 111 111111111         
                                    
    1       1             1         
    1       1             1         
    1       1             1         
    1       1             1         
    1       1             1         
    1       1             1         
    : 1111111 11111 1111116         
                                    
    1       1     1                 
    1       1     1                 
    1       1     1                 
    1       1     1                 
    1   1 111 11111                 
    1                               
    1   1                           
    1   1                           
    1   1                           
    1   1                           
    1 111 11111 111111111 111111111 
                                    
    1         1         1         1 
    1         1         1         1 
    1 111111111 11111 111 111 11111 
                                    
                    1       1     1 
                    1       1     1 
                    4       1     1 
                    1       1     1 
                    1 111 112 11111 
                                    
                        1         1 
                        1         1 
                        1         1 
                        1         1 
                        1 111111111 
                                    
                        1         1 
                        1         1 
        1 11111 111111111         1 
                                  1 
        1     1         1 11111 111 
        1     1                     
        3     1         1     1     
        1     1         1     1     
        1     1         1     1     
        1     1         1     1     
  1 11111 11111 111111111     1     
                              1     
  1           1               6     
  1           1               1     
  1 11111 11111               1     
                              1     
  1     1     1               1     
  1     1     1               1     
  1     1     1 1111111 111 11:     
  1     1                           
  1     1             1   1         
  1     1             1   1         
  1     1             1   1         
  1     1             1   1         
  1 11111 1111111111111   1         
                          1         
        1                 1         
        1                 1         
        8 111111111 1111111         
                                    
        1         1                 
        1         1                 
        1         1                 
        1         1                 
        1 11111111: 1111111111111   
                                    
        1         1             1   
        1         1             1   
        1         1             1   
        1         1             1   
        1 111 11111 1111111 11111   
                                    
            1             1         
            1             1         
            1             1         
            1             1         
            1 1111  1111111         
                                    
                                    
                                    
                                    
                                    
                                    
                                    
                                    
                                    
*