Textures/grave2.bmp
8 0
8 155
0
    300070002     
    1   1   1     
    1 B 1 D 1     
    4000:0005     
        1         
        1         
        1         
  300000:000002   
  1     1     1   
F 1 A   1  A  1 F 
  1F 3006002  1   
  1  1     1F 1   
F 1  1  C  1  1 F 
  8009     8009   
  1  1     1  1   
F 1  4007005  1 F 
  1A    1   A 1   
  1     1     1   
F 4707006007075 F 
   1 1     1 1    
   1 1  C  1 1    
   1 1     1 1    
3009 1     1 8002 
1  1 4070705 1  1 
1  1   1 1   1  1 
1  1   1 1   1  1 
1  40709 80705  1 
1E   1 1 1 1  B 1 
1    1 1 1 1    1 
807005 1 1 400709 
1 1    1 1    1 1 
1 1D   1 1  D 1 1 
40:0000:0:0000:05 
  1    1 1    1   
  1 F  1 1  F 1   
30600705 40700602 
1    1     1    1 
1 E  1  C  1 A  1 
800009     800009 
1    8000009    1 
800009     800009 
1    1  B  1    1 
1 F  1     1 F  1 
40700600700600705 
  1     1     1   
F 1  D  1  D  1 F 
  1     1     1   
30600000:00000602 
1       1       1 
1  C    1  C    1 
1       1       1 
80000070607000009 
1     1   1     1 
1   F 1 B 1 F   1 
402   1   1   305 
  1   1   1   1   
  80005   40009   
  1     C     1   
  1           1   
  4070007000705   
    1   1   1     
  F 1   1   1 F   
    1   1   1     
    1   1   1     
30009   1   80002 
1   1   1   1   1 
1F  1 A 1 F 1 E 1 
1   1   1   1   1 
1   1   1   1   1 
8000:0006000:0009 
1   1       1   1 
1   1       1   1 
1   1 D   F 1   1 
80009       80009 
1   1   C   1   1 
1   1 F   D 1   1 
1   1       1   1 
80006007070060009 
1      1 1      1 
1  A   1 1   A  1 
40700705 40700705 
  1  1     1  1   
  1  1     1  1   
  1  8007009  1   
  4075  1  4705   
    1   1   1     
30009 F 1 F 80002 
1   1   1   1   1 
80006070607060009 
1     1   1     1 
1 D   1   1  D  1 
80070060706007009 
1  1    1    1  1 
1F 1    1    1F 1 
1  1 B  1 B  1  1 
80060070:07006009 
1     1 1 1     1 
1   D 1 1 1 B   1 
8002  1 1 1  3009 
1  1  1 1 1  1  1 
1  8005 1 4009  1 
1  1    1    1  1 
1  1    1    1  1 
40067000600076005 
    1       1     
    1   A   1     
    4000;0005     
        1         
     F  1 F       
        1         
     F  1 F       
        1         
*
        1 1111111 1111111           
                                    
        1       1       1           
        1       1       1           
        1       1       1           
        1       1       1           
        1 1111111 1111111           
                                    
                1                   
                1                   
                1                   
                1                   
                1                   
                1                   
    2 11111111111 11111111115       
                                    
    1           1           1       
    1           1           1       
    1           1           1       
    1           1           1       
    1     4 11111 11113     1       
    1                       1       
    1     1           1     1       
    1     1           1     1       
    1     1           1     1       
    1     1           1     1       
    1 11111           1 11111       
                                    
    1     1           1     1       
    1     1           1     1       
    1     3 11111 11114     1       
    1                       1       
    1           1           1       
    1           1           1       
    1           1           1       
    1           1           1       
    5 1 111 11111 11111 111 2       
                                    
      1   1           1   1         
      1   1           1   1         
      1   1           1   1         
      1   1           1   1         
      1   1           1   1         
      1   1           1   1         
1 11111   1           1   1 11111   
          1           1             
1     1   1 111 111 111   1     1   
1     1                   1     1   
1     1       1   1       1     1   
1     1       1   1       1     1   
1     1       1   1       1     1   
1     1       1   1       1     1   
1     7 111 111   1 111 118     1   
1                               1   
1         1   1   1   1         1   
1         1   1   1   1         1   
1         1   1   1   1         1   
1         1   1   1   1         1   
6 111 11111   1   1   1 11111 116   
              1   1                 
1   1         1   1         1   1   
1   1         1   1         1   1   
1   1         1   1         1   1   
1   1         1   1         1   1   
2 111 111111111 111 111111111 112   
                                    
    1         1   1         1       
    1         1   1         1       
    1         1   1         1       
    1         1   1         1       
1 111 11111 111   1 111 11111 111   
                                    
1         1           1         1   
1         1           1         1   
1         1           1         1   
1         1           1         1   
1 111111111           1 111111111   
                                    
1         1 11111111111         1   
1                               1   
6 111111111           1 111111113   
                                    
1         1           1         1   
1         1           1         1   
1         1           1         1   
1         1           1         1   
1 111 11111 11111 11111 11111 111   
                                    
    1           1           1       
    1           1           1       
    1           1           1       
    1           1           1       
    1           1           1       
    1           1           1       
1 111 1111111111; 11111111111 111   
                                    
1               1               1   
1               1               1   
1               1               1   
1               1               1   
1               1               1   
1               1               1   
1 11111111111 111 111 11111111111   
                                    
1           1       1           1   
1           1       1           1   
1           1       1           1   
1           1       1           1   
1 111       1       1       1 111   
            1       1               
    1       1       1       1       
    1       1       1       1       
    1 1111111       1 1111111       
                                    
    1                       1       
    1                       1       
    1                       1       
    1                       1       
    6 111 111111> 1111111 115       
                                    
        1       1       1           
        1       1       1           
        1       1       1           
        1       1       1           
        1       1       1           
        1       1       1           
        1       1       1           
        1       1       1           
4 1111111       1       1 1111111   
                1                   
1       1       1       1       1   
1       1       1       1       1   
1       1       1       1       1   
1       1       1       1       1   
1       1       1       1       1   
1       1       1       1       1   
1       1       1       1       1   
1       1       1       1       1   
1 1111111 111 111 1111111 1111115   
                                    
1       1               1       1   
1       1               1       1   
1       1               1       1   
1       1               1       1   
        1               1           
1       1               1       1   
1 1111111                       1   
                        1           
1       1               1       1   
1       1               1       1   
1       1               1       1   
1       1               1       1   
1       1               1       1   
1       1               1       1   
1 1111111 11111 111 11111 1111111   
                                    
1             1   1             1   
1             1   1             1   
1             1   1             1   
1             1   1             1   
1 111 11111 111   1 111 11111 111   
                                    
    1     1           1     1       
    1     1           1     1       
    1     1           1     1       
    1     1           1     1       
    1     1 11111 11111     1       
    2                       2       
    1 111 1     1     1 1 111       
                1                   
        1       1       1           
        1       1       1           
1 1111111       1       1 1111111   
                1                   
1       1       1       1       1   
1       1       1       1       1   
1 1111111 111 111 111 111 1111111   
                                    
1           1       1           1   
1           1       1           1   
1           1       1           1   
1           1       1           1   
1 11111 11111 111 111 11111 11111   
                                    
1     1         1         1     1   
1     1         1         1     1   
1     1         1         1     1   
1     1         1         1     1   
1     1         1         1     1   
1     1         1         1     1   
4 11111 11111 113 111 11111 11114   
                                    
1           1   1   1           1   
1           1   1   1           1   
1           1   1   1           1   
1           1   1   1           1   
1 11111     1   1   1     1 11111   
            1   1   1               
1     1     1   1   1     1     1   
1     1     7   1   8     1     1   
1     1 11111   1   1 11111     1   
1               1               1   
1     1         1         1     1   
1     1         1         1     1   
1     1         1         1     1   
1     1         1         1     1   
1 11111 1 1111115 1111111 1 11111   
                                    
        1               1           
        1               1           
        1               1           
        1               1           
        1 111111  1111111           
                                    
                                    
                                    
                                    
                                    
                                    
                                    
                                    
                                    
                                    
                                    
*