Textures/grave2.bmp
8 0
11 94
0
    3000000002    
    1        1    
    1   E    1    
    8000000709    
    1      1 40002
    1  B   1     1
    80000009     1
    1      1   A 1
    1  C   1     1
3000:000000:007005
1   1      1  1   
1   1      1  1   
1 F 1 D    1F 1   
1   1      1  1   
407060007006075   
  1     1    1    
  1     1    1    
  407007607009    
    1  1  1  1    
    1  1  1  1    
  A 800:009  1    
    1  1  1F 1    
    1  1  1  1    
    800600:0060002
  D 1     1      1
    1 A   1  E   1
    1     1      1
300067000060007005
1    1        1   
1    1F  C  F 1   
1    1        1   
40000:000700006002
     1   1       1
     1   1       1
     1   1       1
     4707670700005
      1 1 1 1     
    E 1 1 1 1     
      1 1 1 1 A   
      1 1 1 1     
300700606060607002
1  1          1  1
1F 1    C     1F 1
400:00700000076075
   1  1      1  1 
   1  1      1  1 
   1  1    D 1  1 
   4075      4705 
     1   B    1   
     1        1   
   F 4070000705F  
       1    1     
   30075 A  47002 
   1  1      1  1 
   800:0000706705 
   1  1    1  1   
   1  1    1  1   
   400:0000:005   
      1    1      
3000009    1      
1     1    1 F A  
1  E  1 C  1      
1     1    800002 
8007009    1    1 
1  1  1    1    1 
1  1  80000600075 
1  1  1        1  
4705  1   B    1  
 1    4007000075  
 1F      1    1   
 1       1    1   
 470007005    1   
  1   1    D  1   
  1   1       1   
  1 A 1E  30009   
  1   1   1   1   
306070600067005   
1   1      1      
1   1      1      
1 B 1      1      
1   1      1      
1   1F  C  8000002
1   1      1     1
400067000009  A  1
     1     1     1
     4007006070009
        1    1   1
        1 E  1   1
        1    1   1
        400;060005
           1      
           1      
         F 1 F    
           1      
           1      
*
        1 11111111111111111         
                                    
        1                 1         
        1                 1         
        1                 1         
        1                 1         
        1 1111111111111 111         
                                    
        1             1   1 1111111 
        1             1             
        1             1           1 
        1             1           1 
        4 1111111111111           1 
                                  1 
        1             1           1 
        1             1           1 
        1             1           1 
        1             1           1 
1 1111111 1111111111111 11111 11111 
                                    
1       1             1     1       
1       1             1     1       
1       1             1     1       
1       1             1     1       
1       1             1     1       
1       1             1     1       
1       1             1     1       
1       1             1     1       
6 111 111 1111111 11113 111 1       
                                    
    1           1         1         
    1           1         1         
    1           1         1         
    1           1         1         
    1 111 11111 1 111 11111         
                                    
        1     1     1     1         
        1     1     1     1         
        1     1     1     1         
        1     1     1     1         
        1 11111 11111     1         
                          1         
        1     1     1     1         
        1     1     1     1         
        1     1     1     1         
        1     1     1     1         
        1 1111: 11111 11115 1111111 
                                    
        1           1             1 
        1           1             1 
        1           1             1 
        1           1             1 
        1           1             1 
        1           1             1 
3 1111111 1 111111111 1111111 11111 
                                    
1         1                 1       
1         1                 1       
1         1                 1       
1         1                 1       
1         1                 1       
1         1                 1       
1 111111111 1111117 111111111 11114 
                                    
          1       1               1 
          1       1               1 
          1       1               1 
          1       1               1 
          1       1               1 
          1       1               1 
          1 1 111 1 > 111 111111111 
                                    
            1   1   1   1           
            1   1   1   1           
            1   1   1   1           
            1   1   1   1           
            1   1   1   1           
            1   1   1   1           
            1   1   1   1           
            1   1   1   1           
6 11111 11111 111 111 111 111 11111 
                                    
1     1                     1     1 
1     1                     1     1 
1     1                     1     1 
1     1                     1     1 
1 11111 11111 1111111111111 1 111 3 
                                    
      1     1             1     1   
      1     1             1     1   
      1     1             1     1   
      1     1             1     1   
      1     1             1     1   
      1     1             1     1   
      5 112 1             1 2 115   
                                    
          1                 1       
          1                 1       
          1                 1       
          1                 1       
          1 118 11111111= 111       
                                    
              1         1           
              1         1           
      1 11111 1         1 1 11111   
                                    
      1     1             1     1   
      1     1             1     1   
      1 11111 111111111 111 1 111   
                                    
      1     1         1     1       
      1     1         1     1       
      1     1         1     1       
      1     1         1     1       
      1 11115 111111111 11114       
                                    
            1         1             
            1         1             
1 11111111111         1             
                      1             
1           1         1             
1           1         1             
1           1         1             
1           1         1             
1           1         6 111111117   
1           1                       
1 11111 11111         1         1   
                      1         1   
1     1     1         1         1   
1     1     1         1         1   
1     1     1 111111111 1111111 2   
1     1                             
1     1     1                 1     
1     1     1                 1     
1 : 111     1                 1     
            1                 1     
  1         1 11111 111111111 1     
  1                                 
  1               1         1       
  1               1         1       
  1               1         1       
  1               1         1       
  1 1 1111115 11111         1       
                            1       
    1       1               1       
    1       1               1       
    1       1               1       
    1       1               1       
    1       1       1 111111:       
    1       1                       
    1       1       1       1       
    1       1       1       1       
1 111 111 111 1111111 1 11111       
                                    
1       1             1             
1       1             1             
1       1             1             
1       1             1             
1       1             1             
1       1             1             
1       1             1             
1       1             1             
1       1             7 11111111111 
1       1                           
1       1             1           1 
1       1             1           1 
5 1111111 1 11111111111           1 
                                  1 
          1           1           1 
          1           1           1 
          1 11111 11111 111 1111111 
                                    
                1         1       1 
                1         1       1 
                1         1       1 
                1         1       1 
                1         1       1 
                1         1       1 
                1 1111  111 1111115 
                                    
                                    
                                    
                                    
                                    
                                    
                                    
                                    
                                    
                                    
                                    
*