Textures/classic8.bmp
3 0
8 96
0
300000070007007002
1      1   1  1  1
1      1   1  1  1
1      1   1  1  1
40070006707670:005
   1    1 1 1 1   
   1    1 1 1 1   
   80070606760602 
   1  1    1    1 
   80060070:00009 
   1     1 1    1 
   470700:0:07005 
    1 1  1 1 1    
   367670676062   
   1 1 1  1   1   
   1 1 1  1   1   
   8060670:0709   
   1    1 1 1 1   
   800709 80:09   
   1  1 1 1 1 1   
   1  1 1 1 1 1   
 3060760:060:0602 
 1   1  1   1   1 
 1   1  1   1   1 
 8000:00670060009 
 1   1   1      1 
 1   1   1      1 
 80006000:00700062
 1       1  1    1
 802   309  1    1
 1 1   1 1  1    1
 40600060600670709
             1 1 1
             1 1 1
             80:09
             1 1 1
             1 1 1
             1 1 1
             80:09
             1 1 1
             1 1 1
             80:09
             1 1 1
300700700707060609
1  1  1  1 1     1
1  1  1  1 1     1
1  1  1  1 1     1
40067060060:007009
    1      1  1  1
    1      1  1  1
    8007000:009  1
    1  1   1  1  1
    800:0076006709
    1  1  1    1 1
    1  1  1    1 1
    1  1  1    1 1
    40760767007605
      1  1 1  1   
      1  1 1  1   
 30707600606009   
 1 1 1        1   
 1 1 1        1   
 80606707000709   
 1    1 1   1 1   
 1    1 1   1 1   
 1    1 1   1 1   
 807006060006762  
 1 1         1 1  
 1 1         1 1  
 1 1         1 1  
 80:000700700675  
 1 1   1  1   1   
 1 1   1  1   1   
 1 1   1  1   1   
 80:000600:0006002
 1 1      1      1
 40600070767007009
       1 1 1  1  1
       1 1 1  1  1
       80:0:006009
       1 1 1     1
     30:0606007009
     1 1      1  1
     1 1      1  1
     8067070706005
     1  1 1 1     
     1  1 1 1     
     800:0:09     
     1  1 1 1     
 3070:00606760002 
 1 1 1     1    1 
 4060600;00600005 
        1         
        1         
        1         
        1         
        1         
*
1 1111111111111 1111111 11111 11111 
                                    
1             1       1     1     1 
1             1       1     1     1 
1             1       1     1     1 
1             1       1     1     1 
1             1       1     1     1 
1             1       1     1     1 
1 11111 1121111 1 111 1 1 111 11111 
                                    
      1         1   1   1   1       
      1         1   1   1   1       
      1         1   1   1   1       
      1         1   1   1   1       
      1 11111 111 111 1 1 111 111   
                                    
      1     1         1         1   
      1     1         1         1   
      1 11111 11111 111 111111111   
                                    
      1           1   1         1   
      1           1   1         1   
      1 1 111 81111 111 111 11111   
                                    
        1   1     1   1   1         
        1   1     1   1   1         
      1 1 1 1 1 111 1 1 111 1       
                                    
      1   1   1     1       1       
      1   1   1     1       1       
      1   1   1     1       1       
      1   1   1     1       1       
      1 111 111 1 111 111 111       
                                    
      1         1   1   1   1       
      1         1   1   1   1       
      1 11111 111   1 111 111       
                                    
      1     1   1   1   1   1       
      1     1   1   1   1   1       
      1     1   1   1   1   1       
      1     1   1   1   1   1       
  1 111 111 1 11> 111 111 411 111   
                                    
  1       1     1       1       1   
  1       1     1       1       1   
  1       1     1       1       1   
  1       1     1       1       1   
  1 1111111 11111 1 11111 2111111   
                                    
  1       1       1             1   
  1       1       1             1   
  1       1       1             1   
  1       1       1             1   
  1 1111111 1111111 11111 1111111 1 
                                    
  1               1     1         1 
  1               1     1         1 
  1 111       1 111     1         1 
                        1         1 
  1   1       1   1     1         1 
  1   1       1   1     1         1 
  1 111 1111811 111 11111 1 111 111 
                                    
                          1   1   1 
                          1   1   1 
                          1   1   1 
                          1   1   1 
                          1 111 511 
                                    
                          1   1   1 
                          1   1   1 
                          1   1   1 
                          1   1   1 
                          1   1   1 
                          1   1   1 
                          1 111 111 
                                    
                          1   1   1 
                          1   1   1 
                          1   1   1 
                          1   1   1 
                          1 111 111 
                                    
                          1   1   1 
                          1   1   1 
1 11111 11111 11114 111 111 111 111 
                                    
1     1     1     1   1           1 
1     1     1     1   1           1 
1     1     1     1   1           1 
1     1     1     1   1           1 
1     1     1     1   1           1 
1     1     1     1   1           1 
1 11111 1 111 11111 111 11211 11111 
                                    
        1             1     1     1 
        1             1     1     1 
        1             1     1     1 
        1             1     1     1 
        1 11111 1111111 11111     1 
                                  1 
        1     1       1     1     1 
        1     1       1     1     1 
        1 51111 11111 1 11111 1 111 
                                    
        1     1     1         1   1 
        1     1     1         1   1 
        1     1     1         1   1 
        1     1     1         1   1 
        1     1     1         1   1 
        1     1     1         1   1 
        1 111 1 111 1 1 81111 1 111 
                                    
            1     1   1     1       
            1     1   1     1       
            1     1   1     1       
            1     1   1     1       
  1 111 111 1 11111 111 11111       
                                    
  1   1   1                 1       
  1   1   1                 1       
  1   1   1                 1       
  1   1   1                 1       
  1 111 111 1 111 1111111 111       
                                    
  1         1   1       1   1       
  1         1   1       1   1       
  1         1   1       1   1       
  1         1   1       1   1       
  1         1   1       1   1       
  1         1   1       1   1       
  1 111 11111 111 1111111 1 1 1     
                                    
  1   1                   1   1     
  1   1                   1   1     
  1   1                   1   1     
  1   1                   1   1     
  1   1                   1   1     
  1   1                   1   1     
  1 111 1111111 11211 11111 1 1     
                                    
  1   1       1     1       1       
  1   1       1     1       1       
  1   1       1     1       1       
  1   1       1     1       1       
  1   1       1     1       1       
  1   1       1     1       1       
  1 111 1111111 11111 1111114 11111 
                                    
  1   1             1             1 
  1   1             1             1 
  1 111 8111111 113 1 1 11111 11111 
                                    
              1   1   1     1     1 
              1   1   1     1     1 
              1   1   1     1     1 
              1   1   1     1     1 
              1 111 111 11111 11111 
                                    
              1   1   1           1 
              1   1   1           1 
          1 111 111 111 11111 11111 
                                    
          1   1             1     1 
          1   1             1     1 
          1   1             1     1 
          1   1             1     1 
          1 11; 1 111 111 111 11111 
                                    
          1     1   1   1           
          1     1   1   1           
          1     1   1   1           
          1     1   1   1           
          1 11111 111 111           
                                    
          1     1   1   1           
          1     1   1   1           
  1 111 111 11111 111 1 1 5111111   
                                    
  1   1   1           1         1   
  1   1   1           1         1   
  1 111 111 11111111111 111171111   
                                    
                                    
                                    
                                    
                                    
                                    
                                    
                                    
                                    
                                    
                                    
*