Textures/grave2.bmp
7 0
11 94
0
     300002       
     1    1       
     1  E 1       
     80000:002    
     1    1  1    
     1 B  8009    
     800009  1    
     1    1A 1    
     1 C  1  1    
 300760000:009    
 1  1     1  1    
 1  1     1  1    
 1F 1 D   1  1    
 4076000706009    
   1    1    1    
   1    1    1    
   1    1    1    
   47007607009    
    1  1  1  1    
    1  1  1  1    
  A 800:009  1    
    1  1  1F 1    
    1  1  1  1    
    800670670602  
  D 1   1  1   1  
    1 A 1  1 E 1  
    1   1  1   1  
   3607060060705  
   1  1      1    
   1  1F C F 1    
   1  1      1    
   407600700062   
     1   1    1   
     1   1    1   
     4707670705   
      1 1 1 1     
      1 1 1 1     
    E 809 809     
      1 1 1 1 A   
      1 1 1 1     
300700:06067607002
1  1  1    1  1  1
1F 1  1 C  1  1F 1
400:00:00006076075
   1  1      1  1 
   1  1   D  1  1 
   40762    36705 
     1 1    1 1   
     809 B  809   
     1 1    1 1   
   F 80:0000:09F  
     1 1    1 1   
   30675 A  47602 
   1  1      1  1 
   80067007006705 
   1   1  1   1   
   1   1  1   1   
   400760067005   
      1    1      
  30009 C  1      
  1   800709 F A  
  1E  1  1 1      
  1   1  1 800002 
3067009  409    1 
1  1  1    1    1 
1  1  80700600075 
1  1  1 1      1  
4705  1 1 B    1  
 1    4067007075  
 1F      1  1 1   
 1       800609   
 470007005    1   
  1   1    D  1   
  1   1    3009   
  1 A 1E   1  1   
30:070:07009  1   
1 1 1 1 1  8005   
805 1 1 4009      
1   805    1      
1 B 1      1      
80009      1      
1   1F  C  1      
1   1      8002   
400067007009  1   
     1  1  1A 1   
     400:006076002
        1    1   1
        1 E  1   1
        1    1   1
        400;060005
           1      
           1      
         F 1 F    
           1      
           1      
*
          1 111111111               
                                    
          1         1               
          1         1               
          1         1               
          1         1               
          1 111111111 11111         
                                    
          1         1     1         
          1         1     1         
          1         1 11111         
          1                         
          4 111111111     1         
                          1         
          1         1     1         
          1         1     1         
          1         1     1         
          1         1     1         
  1 11111 1 111111111 11111         
                                    
  1     1           1     1         
  1     1           1     1         
  1     1           1     1         
  1     1           1     1         
  1     1           1     1         
  1     1           1     1         
  1 111 6 1111111 113 11111         
                                    
      1         1         1         
      1         1         1         
      1         1         1         
      1         1         1         
      1         1         1         
      1         1         1         
      1 1 11111 1 111 11111         
                                    
        1     1     1     1         
        1     1     1     1         
        1     1     1     1         
        1     1     1     1         
        1 11111 11111     1         
                          1         
        1     1     1     1         
        1     1     1     1         
        1     1     1     1         
        1     1     1     1         
        1 1111: 1 111 1 115 111     
                                    
        1       1     1       1     
        1       1     1       1     
        1       1     1       1     
        1       1     1       1     
        1       1     1       1     
        1       1     1       1     
      3 1 111 111 11111 111 111     
                                    
      1     1             1         
      1     1             1         
      1     1             1         
      1     1             1         
      1     1             1         
      1     1             1         
      1 111 1 11117 1111111 4       
                                    
          1       1         1       
          1       1         1       
          1       1         1       
          1       1         1       
          1 1 111 1 > 111 111       
                                    
            1   1   1   1           
            1   1   1   1           
            1   1   1   1           
            1   1   1   1           
            1 111   1 111           
                                    
            1   1   1   1           
            1   1   1   1           
            1   1   1   1           
            1   1   1   1           
6 11111 11111 111 111 1 1 111 11111 
                                    
1     1     1         1     1     1 
1     1     1         1     1     1 
1     1     1         1     1     1 
1     1     1         1     1     1 
1 11111 11111 111111111 111 1 111 3 
                                    
      1     1             1     1   
      1     1             1     1   
      1     1             1     1   
      1     1             1     1   
      5 112 1 1         1 1 2 115   
                                    
          1   1         1   1       
          1   1         1   1       
          1 111         1 111       
                                    
          1   1         1   1       
          1   1         1   1       
          1 118 11111111= 111       
                                    
          1   1         1   1       
          1   1         1   1       
      1 111 1 1         1 1 1 111   
                                    
      1     1             1     1   
      1     1             1     1   
      1 11111 1 11111 11111 1 111   
                                    
      1       1     1       1       
      1       1     1       1       
      1       1     1       1       
      1       1     1       1       
      1 11115 1 11111 1 11114       
                                    
            1         1             
            1         1             
    1 1111111         1             
                      1             
    1       1 11111 111             
    1                               
    1       1     1   1             
    1       1     1   1             
    1       1     1   6 111111117   
    1       1     1                 
1 111 1 11111     1 111         1   
                                1   
1     1     1         1         1   
1     1     1         1         1   
1     1     1 111 11111 1111111 2   
1     1                             
1     1     1   1             1     
1     1     1   1             1     
1 : 111     1   1             1     
            1   1             1     
  1         1 111 1 11111 111 1     
  1                                 
  1               1     1   1       
  1               1     1   1       
  1               1 11111 111       
  1                                 
  1 1 1111115 11111         1       
                            1       
    1       1               1       
    1       1               1       
    1       1         1 11111       
    1       1                       
    1       1         1     1       
    1       1         1     :       
1 111 113 111 111 11111     1       
                            1       
1   1   1   1   1     1 11111       
1   1   1   1   1                   
1 111   1   1   1 11111             
        1   1                       
1       1 111         1             
1                     1             
1       1             1             
1       1             1             
1 1111111             1             
                      1             
1       1             1             
1       1             1             
1       1             7 11111       
1       1                           
5 1111111 1 11111 11111     1       
                            1       
          1     1     1     1       
          1     1     1     1       
          1 11111 11111 111 1 11111 
                                    
                1         1       1 
                1         1       1 
                1         1       1 
                1         1       1 
                1         1       1 
                1         1       1 
                1 1111  111 1111115 
                                    
                                    
                                    
                                    
                                    
                                    
                                    
                                    
                                    
                                    
                                    
*