
      1 1   1     
3000009 1   1     
1     1 1   1 E   
1     1 1   1     
4700009 8000:00002
 1    1 1   1    1
 1 F  809 E 1    1
 1    1 1   1 I  1
 800009 1   1    1
 1    1 4000:00009
 1 G  1     1    1
 1    1     1 G  1
 1    1     1    1
 1    1  L  1E   1
 40700607000607005
   1    1     1   
   1 F  1     1   
   1    1   H 1   
300600706007006002
1     1    1     1
1     1 G  1  F  1
1 D   1    1     1
400700607006070075
   1    1    1  1 
   1 E  1 E  1  1 
   1    1    1  1 
   80000600009  1 
   1         1  1 
   1    E    1  1 
   1 C    B  1  1 
3006070000700:005 
1    1    1  1    
1    1    1  1    
40000:00009  1    
     1    1  1 I  
     1 G  1  1    
     1    1  1    
30000:00009  1    
1    1    80060002
1    1 F  1      1
1    1    1      1
1 K  1    1 E J  1
4007067000:0000009
   1  1   1      1
   1F 1 G 1      1
   1  1   80000005
   1  1   1       
   1  1   1       
   80060006002 D  
3009         1    
1  1         1    
8009         1 E  
1  1   A     1    
1  8007000700:002 
1  1  1   1  1  1 
1  1  1G  1  1  1 
1  1E 1   1  1  1 
1  1  1H  1  4705 
47060060705   1   
 1      1     1   
 1F   F 1     1   
 1      1   E 1   
 1      1     1   
 8007000600000:002
 1  1         1  1
 1  1G      G 1  1
 1  1         1  1
 1  1   B  E  1  1
 40060000000076009
*

            1   1       1           
            1   1       1           
1 11111111111   1       1           
                1       1           
1           1   1       1           
1           1   1       1           
1           1   1       1           
1           1   1       1           
1 1 111111111   1 1111111 111111111 
                                    
  1         6   1       1         1 
  1         1   1       1         1 
  1         1 111       1         1 
  1                     1         1 
  1         1   1       1         1 
  1         1   1       1         1 
  1 111111111   1       1         1 
                1       1         1 
  1         1   1 1111111 111111113 
  1         1                       
  1         1           1         1 
  1         1           1         1 
  1         1           1         1 
  1         1           1         1 
  1         1           1         1 
  1         1           1         1 
  1         1           1         1 
  1         1           1         1 
  1 111 1111= 111 1111111 114 11111 
                                    
      1         1           1       
      1         1           1       
      1         1           1       
      1         1           1       
      1         1           1       
      1         1           1       
1 11111 11111 111 11111 11111 11111 
                                    
1           1         1           1 
1           1         1           1 
1           1         1           1 
1           1         1           1 
1           1         1           1 
1           1         1           1 
6 11111 11111 111 11111 111 11117 1 
                                    
      1         1         1     1   
      1         1         1     1   
      1         1         1     1   
      1         1         1     1   
      1         1         1     1   
      1         1         1     1   
      1 111111112 111111111     1   
                                1   
      1                   1     1   
      1                   1     1   
      1                   1     1   
      1                   1     1   
      1                   1     1   
      1                   1     1   
1 11111 111 111111113 11111 11111   
                                    
1         1         1     1         
1         1         1     1         
1         1         1     1         
1         1         1     1         
1 111111111 111111111     1         
                          1         
          1         1     1         
          1         1     1         
          1         1     1         
          1         1     1         
          1         1     1         
          1         1     1         
1 11111111: 111111111     1         
                          1         
1         1         1 11111 1111111 
1         1                         
1         1         1             1 
1         1         1             1 
1         1         1             1 
1         1         1             1 
1         1         1             1 
1         1         1             1 
1 11113 111 1 1111111 1111111111114 
                                    
      1     1       1             1 
      1     1       1             1 
      1     1       1             1 
      1     1       1             1 
      1     1       2 1111111111111 
      1     1                       
      1     1       1               
      1     1       1               
      1     1       1               
      1     1       1               
      1 11111 1111111 11111         
                                    
1 11111                   1         
                          1         
1     1                   1         
1     1                   1         
5 11111                   1         
                          1         
1     1                   1         
1     1                   1         
1     1 11118 1111111 11111 11111   
1                                   
1     1     1       1     1     1   
1     1     1       1     1     1   
1     1     1       1     1     1   
1     1     1       1     1     1   
1     1     1       1     1     1   
1     1     1       1     1     1   
1     1     1       1     1 : 111   
1     1     1       1               
1 2 111 11111 111 111       1       
                            1       
  1             1           1       
  1             1           1       
  1             1           1       
  1             1           1       
  1             1           1       
  1             1           1       
  1             1           1       
  1             1           1       
  1 11111 1111113 11111111111 11111 
                                    
  1     1                   1     1 
  1     1                   1     1 
  1     1                   1     1 
  1     1                   1     1 
  1     1                   1     1 
  1     1                   1     1 
  1     1                   1     1 
  1     1                   1     1 
  1 11111 11111111111111111 1 11111 