  1          1   1
  1          1   1
  1    3000009   1
  1    1     1   1
  1    1     1   1
  1    1     1   1
  80000:00000:0009
  1    1     1   1
  1    1     1   1
  1    1     1   1
  80000:000009   1
  1    1     1   1
  1    1     1   1
  1    1     1   1
  1    40070060009
  1       1      1
  1       1      1
30600000009      1
1         1      1
1         1      1
1         1      1
800000070060000009
1      1         1
1      1         1
1      1         1
4000000:0007000705
       1   1   1  
       1   1   1  
       1   1   1  
  3000060006000:02
  1            1 1
  1            1 1
  4000070000700605
   1          1  1
   1          1  1
300:0000000000:009
1  1          1  1
1  1          1  1
800:0000000000:005
1  1          1   
1  1          1   
800600070000705   


  8000060000600702
  1            1 1
  1            1 1
  4000070007000:05
       1   1   1  
       1   1   1  
       1   1   1  
3000000:0006000602
1      1         1
1      1         1
1      1         1
800000060070000009
1         1      1
1         1      1
1         1      1
40700000009      1
  1       1      1
  1       1      1
  1    30060070009
  1    1     1   1
  1    1     1   1
  1    1     1   1
  80000:000009   1
  1    1     1   1
  1    1     1   1
  1    1     1   1
  80000:00000:0009
  1    1     1   1
  1    1     1   1
  1    1     1   1
  1    4000009   1
  1          1   1
  1          1   1
*
                                    
    1                     1       1 
    1                     1       1 
    1                     1       1 
    1                     1       1 
    1         2 11111111111       1 
    1                             1 
    1         1           1       1 
    1         1           1       1 
    1         1           1       1 
    1         1           1       1 
    1         1           1       1 
    1         1           1       1 
    3 111111111 11111111111 1111111 
                                    
    1         1           1       1 
    1         1           1       1 
    1         1           1       1 
    1         1           1       1 
    1         1           1       1 
    1         1           1       1 
    1 111111111 11111111111       1 
                                  1 
    1         1           1       1 
    1         1           1       1 
    1         1           1       1 
    1         1           1       1 
    1         1           1       1 
    1         1           1       1 
    1         : 11111 11111 1111116 
    1                               
    1               1             1 
    1               1             1 
    1               1             1 
    1               1             1 
1 111 111111111111111             1 
                                  1 
1                   1             1 
1                   1             1 
1                   1             1 
1                   1             1 
1                   1             1 
1                   1             1 
1 1111111111111 11117 1111111111111 
                                    
1             1                   1 
1             1                   1 
1             1                   1 
1             1                   1 
1             1                   1 
1             1                   1 
1 1111111111111 1111111 1111111 111 
                                    
              1       1       1     
              1       1       1     
              1       1       1     
              1       1       1     
              1       1       1     
              1       1       1     
    1 111111111 1111111 1111111 111 
                                    
    1                         1   1 
    1                         1   1 
    1                         1   1 
    1                         1   1 
    1 111111111 111111114 11111 111 
                                    
      1                     1     1 
      1                     1     1 
      1                     1     1 
      1                     1     1 
1 11111  11111111111111111 11 1 111 
                                    
1     1                     1     1 
1     1                     1     1 
1     1                     1     1 
1     1                     1     1 
1 11111 111111111111111111111 11111 
                                    
1     1                     1       
1     1                     1       
1     1                     1       
1     1                     1       
1 11111 1111111 111111111 111       
                                    
1             1         1           
1             1         1           
1             1         1           
1             1         1           
2 1111111111111 111111115           

    1 111111111 111111111 11111 111 
                                    
    1                         1   1 
    1                         1   1 
    1                         1   1 
    1                         1   1 
    : 111111111 1111111 1111111 11= 
                                    
              1       1       1     
              1       1       1     
              1       1       1     
              1       1       1     
              1       1       1     
              1       1       1     
1 1111111111111 1111111 1111111 111 
                                    
1             1                   1 
1             1                   1 
1             1                   1 
1             1                   1 
1             1                   1 
1             1                   1 
1 1111111111118 11111 1111111111114 
                                    
1                   1             1 
1                   1             1 
1                   1             1 
1                   1             1 
1                   1             1 
1                   1             1 
1 111 111111111111111             1 
                                  1 
    1               1             1 
    1               1             1 
    1               1             1 
    1               1             1 
    1         : 11111 11111 1111111 
    1                               
    1         1           1       1 
    1         1           1       1 
    1         1           1       1 
    1         1           1       1 
    1         1           1       1 
    1         1           1       1 
    3 111111111 11111111111       1 
                                  1 
    1         1           1       1 
    1         1           1       1 
    1         1           1       1 
    1         1           1       1 
    1         1           1       1 
    1         1           1       1 
    1 111111111 11111111111 1111116 
                                    
    1         1           1       1 
    1         1           1       1 
    1         1           1       1 
    1         1           1       1 
    1         1           1       1 
    1         1           1       1 
    1         2 11111111111       1 
    1                             1 
    1                     1       1 
    1                     1       1 
    1                     1       1 
    1                     1       1 