Textures/grave1.bmp
8 0
8 106
0
30070000700007002 
1  1    1    1  1 
1  1 G  1 G  1  1 
1  1    1    1  1 
800:0000:0000:009 
1  1    1    1  1 
1K 1    1 J  1H 1 
1  1 300:002 1  1 
800:09  1  80:009 
1  1 400:005 1  1 
1  1    1    1  1 
1  1    1    1  1 
400:0000:0000:005 
   1    1    1    
   1  I 1L   1    
   402  1  305 G  
     1  1  1      
   H 800:009      
     1  1  1      
     1  1  1 I LI 
     800:009      
     1  1  1      
   305  1  402    
   1    1    1    
   1  K 1  J 1    
30060000:00006002 
1       1       1 
1       1       1 
1G I 300:002L G 1 
1    1  1  1    1 
1    1  1  1    1 
80000:00:00:00009 
1    1  1  1    1 
1    1  1  1    1 
1G L 400:005I G 1 
1       1       1 
1       1       1 
40000070:07000005 
      1 1 1       
   K  1 1 1 H     
  30009 1 80002   
  1   1 1 1   1   
G 1   1 1 1   1G  
  40009 1 80005   
      1 1 1       
      1 1 1       
300000:060:000002 
1     1   1     1 
402 305 L 402 305 
  1 1       1 1   
  1 400070005 1J  
  1     1     1   
  800000:000009   
  1     1     1   
  800000:000009   
K 1     1     1   
305   I 1I    402 
1       1       1 
1G   300:002  G 1 
1    1  1  1    1 
40000:00:00:00005 
     1  1  1      
   30600:00602    
   1    1    1    
   1L   1  L 1    
   40700:00705    
     1  1  1      
     1  1  1      
     470:075      
      1 1 1       
  J I 1 1 1 G     
      1 1 1       
      1 1 1       
 3070060:0600702  
 1 1    1    1 1  
 1 1 K  1  H 1 1  
 1 40700:00705 1  
 1   1  1  1   1  
 80009G 1G 80009  
 1   1  1  1   1  
 1   1  1  1   1  
 40705  1  40705  
   1    1    1    
   80000:00009    
3009    1    8002 
1  1    1    1  1 
1  1 L  1 I  1  1 
1  1    1    1  1 
1  80000:00009  1 
1  1    1    1  1 
4709 J  1    8075 
 1 1    1 K  1 1  
 1 40070:07005 1  
 1    1 1 1    1  
 4007060:0607005  
    1   1   1     
    1   1   1     
    1I  1 I 1     
    1   1   1     
    800060009     
    1       1     
    1       1     
    4000;0005     
        1         
        1         
    G   1  G      
        1         
*
1 11111 111111111 111111111 11111   
                                    
1     1         1         1     1   
1     1         1         1     1   
1     1         1         1     1   
1     1         1         1     1   
1     1         1         1     1   
1     1         1         1     1   
1 11111 111111111 111111111 11111   
                                    
1     1         1         1     1   
1     1         1         1     1   
1     1         1         1     1   
1     1         1         1     1   
1     1   4 11111 11115   1     1   
1     1                   1     1   
1 11111 111     1     1 111 11111   
                1                   
1     1   5 11111 11114   1     1   
1     1                   1     1   
1     1         1         1     1   
1     1         1         1     1   
1     1         1         1     1   
1     1         1         1     1   
: 11111 111111111 111111111 1111:   
                                    
      1         1         1         
      1         1         1         
      1         1         1         
      1         1         1         
      1 115     1     5 111         
                1                   
          1     1     1             
          1     1     1             
          1 11111 11111             
                                    
          1     1     1             
          1     1     1             
          1     1     1             
          1     1     1             
          1 11111 11111             
                                    
          1     1     1             
          1     1     1             
      1 116     1     6 111         
                1                   
      1         1         1         
      1         1         1         
      1         1         1         
      1         1         1         
6 11111 111111111 111111111 11114   
                                    
1               1               1   
1               1               1   
1               1               1   
1               1               1   
1         1 11111 11111         1   
1                               1   
1         1     1     1         1   
1         1     1     1         1   
1         1     1     1         1   
1         1     1     1         1   
2 111111111 11115 11111 111111112   
                                    
1         1     1     1         1   
1         1     1     1         1   
1         1     1     1         1   
1         1     1     1         1   
1         1 11111 11111         1   
1                               1   
1               1               1   
1               1               1   
1               1               1   
1               1               1   
4 11111111111 111 111 11111111116   
                                    
            1   1   1               
            1   1   1               
            1   1   1               
            1   1   1               
    4 1111111   1   1 1111114       
                1                   
    1       1   1   1       1       
    1       1   1   1       1       
    1       1   >   1       1       
    1       1   1   1       1       
    5 1111111   1   1 1111115       
                1                   
            1   1   1               
            1   1   1               
            1   1   1               
            1   1   1               
1 11111111111 113 111 11111111111   
                                    
1           1       1           1   
1           1       1           1   
1 111   1 111       1 111   1 111   
                                    
    1   1               1   1       
    1   1               1   1       
    1   4 1111111 1111114   1       
    1                       1       
    1           1           1       
    1           1           1       
    1 1111111111; 11111111111       
                                    
    1           1           1       
    1           1           1       
    1 11111111111 11111111111       
                                    
    1           1           1       
    1           1           1       
1 118           1           8 111   
                1                   
1               1               1   
1               1               1   
1         6 11111 11116         1   
1                               1   
1         1     1     1         1   
1         1     1     1         1   
1 111111111 11111 11111 111111111   
                                    
          1     1     1             
          1     1     1             
      1 111 11111 11111 111         
                                    
      1         1         1         
      1         :         1         
      1         1         1         
      1         1         1         
      1 111 11111 11111 111         
                                    
          1     1     1             
          1     1     1             
          1     1     1             
          1     1     1             
          3 1 111 111 3             
                                    
            1   1   1               
            1   1   1               
            1   1   1               
            1   1   1               
            1   1   1               
            1   1   1               
            1   1   1               
            1   1   1               
  2 111 11111 111 111 11111 112     
                                    
  1   1         1         1   1     
  1   1         1         1   1     
  1   1         1         1   1     
  1   1         1         1   1     
  1   1 111 11117 11111 111   1     
  1                           1     
  1       1     1     1       1     
  1       1     1     1       1     
  1 1111111     1     1 1111111     
                1                   
  1       1     1     1       1     
  1       1     1     1       1     
  1       1     1     1       1     
  1       1     1     1       1     
  1 116 111     1     1 116 111     
                1                   
      1         1         1         
      1         1         1         
      1 111111111 111111111         
                                    
4 11111         1         1 11114   
                1                   
1     1         1         1     1   
1     1         1         1     1   
1     1         1         1     1   
1     1         1         1     1   
1     1         1         1     1   
1     1         1         1     1   
1     1 11111111; 111111111     1   
1                               1   
1     1         1         1     1   
1     1         1         1     1   
1 2 111         1         1 112 1   
                1                   
  1   1         1         1   1     
  1   1         1         1   1     
  1   1 11111 111 111 11111   1     
  1                           1     
  1         1   1   1         1     
  1         1   1   1         1     
  1 11115 111 111 111 115 11111     
                                    
        1       1       1           
        1       1       1           
        1       1       1           
        1       1       1           
        1       1       1           
        1       1       1           
        1       1       1           
        1       1       1           
        1 1111111 1111111           
                                    
        1               1           
        1               1           
        1               1           
        1               1           
        1 111111  1111111           
                                    
                                    
                                    
                                    
                                    
                                    
                                    
                                    
                                    
*