Textures/classic3.bmp
0 0
11 61
0
30700007000700002  
1 1    1   1    1  
1 1    1   1    1  
80:002 8000600009  
1 1  1 1        1  
1 1  1 1        1  
80600606007000009  
1         8007005  
80000070005  1     
1     1      1     
400700600070062    
   8000000:0009    
   1      1   1    
   1      1   1    
   1      1   1    
   8000000:0009    
   1   30060009    
   1   1      1    
   8000:0070009    
   1   1  1   1    
   80009  80009    
   1   1  1   1    
3005   1  1   1    
8000070600:0709    
1    1    1 1 1    
800009    1 1 1    
1    800009 409    
1    1    1   1    
8000060000:000602  
1         1     1  
40700070006000009  
  1   1         1  
  4000:0070700005  
      1  1 1       
      1  1 1       
      8005 1       
      1    1       
      40700602     
        800009     
300000005    8002  
1            1  1  
1            1  1  
1            8009  
4007007000000:009  
   1  1      1  1  
   1  1      1  1  
   400:0000006705  
      1       1    
      1       8002 
      800000009  1 
      1       4075 
      1         1  
      40700707075  
        1  1 1 1   
      306009 1 1   
      1    1 1 1   
      1    409 1   
      4070000609   
        1      1   
        400;0005   
           1       
           1       
*
1 111 111111111 1111111 111111112     
                                      
1   1         1       1         1     
1   1         1       1         1     
1   1         1       1         1     
1   1         1       1         1     
1 111 11111   1 1111111 111111111     
                                      
1   1     1   1                 1     
1   1     1   1                 1     
1   1     1   1                 1     
1   1     1   1                 1     
1 111 11111 111 11111111111111111     
                                      
1                   1 11111 11112     
1                                     
1 11111111111 1111111     1           
                          1           
1           1             1           
1           1             1           
1 11111 11111 1111111 11111 1         
                                      
      1 1111111111111 1111111         
                                      
      1             1       1         
      1             1       1         
      1             1       1         
      1             1       1         
      1             1       1         
      1             1       1         
      1 1111111111111 1111111         
                                      
      1       1 11111 1111111         
      1                               
      1       1             1         
      1       1             1         
      1 1111111 11111 1111111         
                                      
      1       1     1       1         
      1       1     1       1         
      1 1111111     1 1111111         
                                      
      1       1     1       1         
      1       1     1       1         
1 11113       1     1       1         
              1     1       1         
1 111111111 111 11111 111 111         
                                      
1         1         1   1   1         
1         1         1   1   1         
1 111111111         1   1   1         
                    1   1   1         
1         1 111111111   1 111         
1                                     
1         1         1       1         
1         1         1       1         
1 111111111 111111111 1111111 112     
                                      
1                   1           1     
1                   1           1     
1 111 1111111 1111111 11111111111     
                                      
    1       1                   1     
    1       1                   1     
    1 1111111 11111 111 111111111     
                                      
            1     1   1               
            1     1   1               
            1     1   1               
            1     1   1               
            1 11111   1               
                      1               
            1         1               
            1         1               
            1 111 11111 111           
                                      
                1 111111111           
                                      
> 111111111111111         1 11111     
                                      
1                         1     1     
1                         1     1     
1                         1     1     
1                         1     1     
1                         1 11111     
1                                     
1 11111 11111 1111111111111 11111     
                                      
      1     1             1     1     
      1     1             1     1     
      1     1             1     1     
      1     1             1     1     
      1 11111 1111111111111 1 111     
                                      
            1               1         
            1               1         
            1               1 11111   
            1                         
            1 111111111111111     1   
                                  1   
            1               1 111 1   
            1                         
            1                   1     
            1                   1     
            4 111 11111 111 111 1     
                                      
                1     1   1   1       
                1     1   1   1       
            1 111 11111   1   1       
                          1   1       
            1         1   1   1       
            1         1   1   1       
            1         1 111   1       
            1                 1       
            1 111 111111111 111       
                                      
                1             1       
                1             1       
                1 11111 1111111       
                                      
                                      
                                      
                                      
                                      
*