Textures/classic4.bmp
8 1
8 78
0
                  
    300070002     
    1   1   1     
    1   1   1     
    1   1   1     
    8000:0009     
    1   1   1     
    1   1   1     
    1   1   1     
    4700:0075     
     1  1  1      
     1  1  1      
     8076076702   
  3009 1  1 1 1   
  1  805  409 1   
306705      806702
1  1        1  1 1
1  1        1  1 1
1  80702    870609
4709 1 1    11   1
 1 1 409    140709
 1 1   1    1  1 1
 806070:0000:009 1
 1   1 1    1  1 1
 1   1 1    1  809
 800060:2   1  1 1
 1     11 305  1 1
 1307005809  30609
 11 1   1 1  1   1
 8:060075 1  1   1
 11    1  800:0709
 1400009  1  1 1 1
 1     1 35  1 1 1
 800700:09 3060:05
 1  1  1 421   1  
 1  1  1  11   1  
 4006705  11 309  
     1    49 1 1  
     1     80:062 
     1     1 1  1 
     8007009 1  1 
     1  1  40600:2
     1  1       11
     800:000070051
     1  1    80009
     1  1    1   1
     8006002 80709
     1     1 1 1 1
     400700:0:0:09
        1  1 1 1 1
        1  1 80605
        8009 1    
        1  1 1    
      30:00675    
      1 1   1     
      1 1   1     
      409 309     
        1 1 1     
     300:0606702  
     1  1    1 1  
     80067007609  
     1   1  1  1  
     80706076075  
     1 1   1  1   
     1 1   1  1   
     80:000:00602 
     1 1   1    1 
     1 1   1  309 
30700:0:0009  1 1 
1 1  1 1   407609 
1 1  409     1  1 
80:02  1     8009 
1 1 1  1     1  1 
4060:006000705  1 
    1      1    1 
    4000;00600005 
        1         
        1         
        1         
*
                                    
                                    
        5 1111111 1111113           
                                    
        1       1       1           
        1       1       1           
        1       1       1           
        1       1       1           
        1       1       1           
        1       1       1           
        1 1111111 1111111           
                                    
        1       1       1           
        1       1       1           
        1       1       1           
        1       1       1           
        1       1       1           
        1       1       1           
        2 1 11111 11111 6           
                                    
          1     1     1             
          1     1     1             
          1     1     1             
          1     1     1             
          1 111 1 111 1 1 111       
                                    
    1 11111   1     1   1   1       
              1     1   1   1       
    1     1 111     1 111   1       
    1                       1       
7 111 1 111             1 111 1 112 
                                    
1     1                 1     1   1 
1     1                 1     1   1 
1     1                 1     1   1 
1     1                 1     1   1 
1     1 111 115         1 1 111 111 
1                                   
1 1 111   1   1         1 1       1 
          1   1         1 1       1 
  1   1   1 111         1 1 111 111 
  1   1                 1           
  1   1       1         1     1   1 
  1   1       1         1     1   1 
  1 111 111 111 111111111 11111   1 
                                  1 
  1       1   1         1     1   1 
  1       1   1         1     1   1 
  1       1   1         1     1 111 
  1       1   1         1           
  1 1111111 111 1       1     1   1 
                        1     1   1 
  1           1 1   1 111     1   1 
  1           1 1             1   1 
  1 1 111 11114 1 111     8 111 111 
  1                                 
  1 1   1       1   1     1       1 
  1 1   1       1   1     1       1 
  1 1 111 11111 1   1     1       1 
                    1     1       1 
  1 1         1     1 11111 111 111 
  1 1         1                     
  1 3 111111111     1     1   1   1 
  1                 1     1   1   1 
  1           1   1 1     1   1   1 
  1           1           1   1   1 
  1 11111 11111 111   1 111 111 111 
                                    
  1     1     1   1 1 1       1     
  1     1     1       1       1     
  1     1     1     1 1       1     
  1     1     1     1 1       1     
  2 11111 1 111     1 1   1 111     
                    1 1             
          1         1 >   1   1     
          1               1   1     
          1           1 111 111 1   
          1                         
          1           1   1     1   
          1           1   1     4   
          5 11111 11111   1     1   
                          1     1   
          1     1     1 111 11111 1 
          1     1                   
          1     1               1 1 
          1     1               1 1 
          1 11111 111111111 11111 1 
                                  1 
          1     1         1 1111111 
          1     1                   
          1     1         1       1 
          1     1         1       1 
          1 11111 11111   1 111 111 
                                    
          1           1   1   1   1 
          1           1   1   1   1 
          : 11111 11111 111 111 111 
                                    
                1     1   1   1   1 
                1     1   1   1   1 
                1     1   1 111 112 
                1     1             
                1 11111   1         
                          1         
                1     1   1         
                1     1   1         
            6 111 11111 1 1         
                                    
            1   1       1           
            1   1       1           
            1   1       1           
            1   1       1           
            3 111   1 111           
                                    
                1   1   1           
                1   1   1           
          1 11111 111 111 1 111     
                                    
          1     1         1   1     
          1     1         1   1     
          1 11111 1 11111 1 111     
                                    
          1       1     1     1     
          1       1     1     1     
          1 111 111 111 1 111 1     
                                    
          1   1       1     1       
          1   1       1     1       
          1   1       1     1       
          1   1       1     1       
          2 111 1111111 11111 111   
                                    
          1   1       1         1   
          1   1       1         1   
          1   1       1     1 111   
          1   1       1             
1 111 11111 111 1111111     1   1   
                            1   1   
1   1     1   1       1 111 1 111   
1   1     1   1                     
1   1     1 111           1     1   
1   1                     1     1   
1 111 111     1           1 11111   
              1                     
1   1   1     1           1     1   
1   1   1     1           1     1   
5 111 111 11111 1111111 111     1   
                                1   
        1             1         1   
        1             1         1   
        3 111111  11111 111111113   
                                    
                                    
                                    
                                    
                                    
                                    
                                    
*