Textures/classic.bmp
6 0
11 79
0
      3002        
      1  80007002 
      4709   1  1 
    300:060706709 
    1  1   8009 1 
    1  1   1  1 1 
    800:0009  475 
    1  1   1   1  
    800:000:0709  
    1  1   1 1 1  
    1  1   1 1 1  
    400:000:0:05  
   30009   1 1    
   1   1   1 1    
   1 30:007605    
   809 1  1       
   1 1 1  1       
   8060:00:02     
   1   1  1 1     
   1   1  1 1     
   8000:00:05     
   1   1  1       
   1   1  1       
   80706705       
   1 1  1         
   1 1  1         
   806009         
   1    1         
   1    1         
   80070:002      
   1  1 1  1      
   800609  1      
   13000:076002   
   11   1 1   1   
   11   8060709   
   11   1   1 1   
   8:00060009 1   
   11      3:09   
   4:07007051 1   
    1 1  1  1 1   
    80600:00:09   
    1    1  1 1   
    1    1  1 1   
3000:0000:00:09   
1   1    1  1 1   
1   1    4009 1   
80009       809   
1   802     1 1   
1   1 1     1 1   
8070:0607000605   
1 1 1   1         
809 80009         
1 1 1   1         
40606070:0702     
      1 1 1 1     
      1 1 1 1     
  3070:09 809     
  1 1 1 1 1 1     
  80:060:0609     
  1 1   1   1     
  1 1   1   1     
  406000:00760702 
        1  1  1 1 
        42 1  1 1 
      30760600:09 
      1 1     1 1 
      1 1     1 1 
     360:000709 1 
     1  1   1 1 1 
     1  1   1 1 1 
     800600060:05 
     1        1   
     1        1   
     4007000009   
        1     1   
        1     1   
        400;005   
           1      
           1      
           1      
*
            1 11111                 
                                    
            1     1 1111111 11111   
            1                       
            1 1 113       1     1   
                          1     1   
        1 11111 111 111 111 1 111   
                                    
        1     1       1 11111   1   
        1     1                 1   
        1     1       1     1   1   
        1     1       1     1   1   
        1 11111 1111111     1 1 1   
                                    
        1     1       1       1     
        1     1       1       1     
        1 11111 1111111 111 111     
                                    
        1     1       1   1   1     
        1     1       1   1   1     
        1     1       1   1   1     
        1     1       1   1   1     
        2 11111 1111111 111 114     
                                    
      1 1111111       1   1         
                      1   1         
      1       1       1   1         
      1       1       1   1         
      1   7 111 11111 1 111         
      1                             
      1 111   1     1               
              1     1               
      1   1   1     1               
      1   1   1     1               
      1 111 111 11111 111           
                                    
      1       1     1   1           
      1       1     1   1           
      1       1     1   1           
      1       1     1   1           
      1 1111111 11111 112           
                                    
      1       1     1               
      1       1     1               
      1       1     1               
      1       1     1               
      1 111 111 1 115               
                                    
      1   1     1                   
      1   1     1                   
      1   1     1                   
      1   1     1                   
      2 111 11111                   
                                    
      1         1                   
      1         1                   
      1         1                   
      1         1                   
      1 11111 111 1111>             
                                    
      1     1   1     1             
      1     1   1     1             
      3 11111 111     1             
                      1             
      1 1 1111111 111 1 11113       
      1                             
      1 1       1   1       1       
      1 1       1   1       1       
      1 1       1 111 111 111       
      1 1                           
      1 1       1       1   1       
      1 1       1       1   1       
      1 1 1111111 1111111   1       
                            1       
      1 1             1 1 111       
      1 1                           
      8 1 111 11111 111 1   1       
                        1   1       
        1   1     1     1   1       
        1   1     1     1   1       
        1 111 11111 11111 111       
                                    
        1         1     1   1       
        1         1     1   1       
        1         1     1   1       
        1         1     1   1       
2 1111111 111111111 11111 111       
                                    
1       1         1     1   1       
1       1         1     1   1       
1       1         1 11111   1       
1       1                   1       
1 1111111               1 11:       
                                    
1       1 111           1   1       
1                       1   1       
1       1   1           1   1       
1       1   1           1   1       
1 111 111 111 118 1111111 111       
                                    
1   1   1       1                   
1   1   1       1                   
1 111   1 1111111                   
                                    
1   1   1       1                   
1   1   1       1                   
5 111 111 111 111 111 111           
                                    
            1   1   1   1           
            1   1   1   1           
            1   1   1   1           
            1   1   1   1           
    2 111 111 111   1 111           
                                    
    1   1   1   1   1   1           
    1   1   1   1   1   1           
    1 111 111 111 111 11:           
                                    
    1   1       1       1           
    1   1       1       1           
    1   1       1       1           
    1   1       1       1           
    1 111 1141111 11111 1 111 111   
                                    
                1     1     1   1   
                1     1     1   1   
                1 1   1     1   1   
                      1     1   1   
            1 111 1 111 11111 111   
                                    
            1   1           1   1   
            1   1           1   1   
            1   1           1   1   
            1   1           1   1   
          : 1 111 1111111 111   1   
                                1   
          1     1       1   1   1   
          1     1       1   1   1   
          1     1       1   1   1   
          1     1       1   1   1   
          1 11111 1111111 111 117   
                                    
          1                 1       
          1                 1       
          1                 1       
          1                 1       
          1 11111 11111111111       
                                    
                1           1       
                1           1       
                1           1       
                1           1       
                1 1111  11111       
                                    
                                    
                                    
                                    
                                    
                                    
                                    
*