Textures/town3.bmp
8 0
9 117
0
300007000000700002
1    1      1    1
1    1E   E 1    1
1    1      1    1
1    1      1    1
1    1 C    1    1
1    1      1    1
1    1E   E 1    1
800006000000600009
1                1
1F      G      F 1
1                1
800000700007000009
1     1    1     1
1     1    1     1
1  H  1D   1  H  1
1     1    1     1
8007009  E 8007009
1  1  1    1  1  1
1G 1F 1    1F 1G 1
1  1  1    1  1  1
1  1  1E   1  1  1
1  1  800009  1  1
8009  1    1  8009
1  1  1    1  1  1
1F 1  1 B  1  1F 1
1  1  1    1  1  1
1  8009    8009  1
1  1  1 E  1  1  1
1  1H 1    1H 1  1
4009  1    1  8005
   1  1 E  1  1   
   800:0000:009   
   1  1    1  1   
   1  1    1  1   
 E 1  1C   1  1E  
   1  1    1  1   
   1  1    1  1   
300607600006706002
1    1      1    1
1 G  1  F   1 G  1
807006700007600709
1 1   1    1   1 1
1 1   1    1   1 1
1 1 E 1    1E  1 1
1 80009 H  80009 1
1 1   1    1   1 1
1 1   1    1   1 1
409   800009   805
  1C  1    1D  1  
  40009 G  80005  
      1    1      
3000009    8000002
1     1 B  1     1
400700670076007005
   1   1  1   1   
   1E  1  1 E 1   
 3060009  8000602 
 1     1  1     1 
 1 F   1  1  F  1 
 4070706006070705 
   1 1      1 1   
   1 1  G   1 1   
   1 1      1 1   
   1 1E     1 1   
   1 1    E 1 1   
30060:000000:06002
1    1      1    1
1 F  1G   G 1 F  1
1    1      1    1
400705      407005
   1          1   
   1   A      1   
   1E       E 1   
   470000000075   
    1        1    
    1G     G 1    
30009   E    80002
1   1        1   1
1   1B    C  1   1
8000:00700700:0009
1   1  1  1  1   1
1F  1  1  1  1 F 1
1   1  1  1  1   1
1   1  1H 1  1   1
1   1  1  1  1   1
1   1  1  1  1   1
80709  8009  80709
1 1 1  1  1  1 1 1
1 1 1  1G 1  1 1 1
1 1 1  1  1  1 1 1
40:06005  40060:05
  1            1  
  1            1  
  1C        B  1  
  1   E   E    1  
  1            1  
  1  F      F  1  
  80700000000709  
  1 1        1 1  
  1 1F  H  G 1 1  
306060700007060602
1     1    1     1
1E    1    1   E 1
1     1    1     1
8000009 B  8000009
1     1    1     1
1F  G 1    1G  F 1
1     1    1     1
1     800009     1
1 E   1    1  E  1
1     1 H  1     1
400;0060000600;005
   1          1   
   1          1   
   400000700005   
         1        
         1        
*
1 111111111 1111111111111 111111111 
                                    
1         1             1         1 
1         1             1         1 
1         1             1         1 
1         1             1         1 
4         1             1         1 
1         1             1         1 
1         1             1         9 
1         1             1         1 
1         1             1         1 
3         1             1         1 
1         1             1         1 
1         1             1         1 
1         1             1         1 
1         1             1         1 
1 111111112 1111111111111 111111111 
                                    
1                                 1 
1                                 1 
1                                 1 
1                                 1 
1                                 1 
1                                 1 
3 11111111111 111111111 11111111113 
                                    
1           1         1           1 
1           1         1           1 
1           1         1           1 
1           1         1           1 
1           1         1           1 
1           1         1           1 
1           1         1           1 
1           1         1           1 
6 11111 11118         = 11111 11111 
                                    
1     1     1         1     1     1 
1     1     1         1     1     1 
1     1     1         1     1     1 
1     1     1         1     1     1 
1     1     1         1     1     1 
1     1     1         1     1     1 
1     1     1         1     1     1 
1     1     1         1     1     1 
1     1     1 111111111     1     1 
1     1                     1     1 
1 11111     1         1     1 11111 
            1         1             
1     1     1         1     1     1 
1     1     1         1     1     1 
1     1     1         1     1     1 
1     1     1         1     1     1 
1     1     1         1     1     1 
1     1     1         1     1     1 
1     1 11114         1 11111     1 
1                                 1 
1     1     1         1     1     1 
1     1     1         1     1     1 
1     1     1         1     1     1 
1     1     1         1     1     1 
1 11111     1         1     1 11112 
            1         1             
      1     1         1     1       
      1     1         1     1       
      1 11117 111111111 11111       
                                    
      1     1         1     1       
      1     1         1     1       
      1     1         1     1       
      1     1         1     1       
      1     1         1     1       
      1     1         1     1       
      1     1         1     1       
      1     1         1     1       
      1     1         1     1       
      1     1         1     1       
1 11114 111 1 111111111 1 111 11111 
                                    
1         1             1         1 
1         1             1         1 
1         1             1         1 
1         1             1         1 
1 111 11111 1 111111111 1 11111 119 
                                    
1   1       1         1       1   1 
1   1       1         1       1   1 
1   1       1         1       1   1 
1   1       1         1       1   1 
1   1       1         1       1   1 
1   1       1         1       1   1 
1   1 1111111         = 1111111   1 
1                                 1 
1   1       1         1       1   1 
1   1       1         1       1   1 
1   1       1         1       1   1 
1   1       1         1       1   1 
1 111       1 111111111       1 111 
                                    
    1       1         1       1     
    1       1         1       1     
    1 1111116         1 1111111     
                                    
            1         1             
            1         1             
1 11111111111         1 11111111111 
                                    
1           1         1           1 
1           1         1           1 
1 11111 11111 1 11112 1 11111 11111 
                                    
      1       1     1       1       
      1       1     1       1       
      1       1     1       1       
      1       1     1       1       
  1 115 1111111     1 1111111 111   
                                    
  1           1     1           1   
  1           1     1           1   
  1           1     1           1   
  1           1     1           1   
  1 111 111 111 11111 111 111 111   
                                    
      1   1             1   1       
      1   1             1   1       
      1   1             1   1       
      1   1             1   1       
      1   1             1   1       
      1   1             1   1       
      1   1             1   1       
      1   1             1   1       
      1   1             1   1       
      1   1             1   1       
1 11114 119 1111111111112 111 11111 
                                    
1         1             1         1 
1         1             1         1 
1         1             1         1 
1         1             1         1 
1         1             1         1 
1         1             1         1 
1 11116 111             1 116 11111 
                                    
      1                     1       
      1                     1       
      1                     1       
      1                     1       
      1                     1       
      1                     1       
      1 1 11111111111111111 1       
                                    
        1                 1         
        1                 1         
        1                 1         
        1                 1         
1 1111117                 = 1111111 
                                    
1       1                 1       1 
1       1                 1       1 
1       1                 1       1 
1       1                 1       1 
5 1111111 11111 11111 11111 1111111 
                                    
1       1     1     1     1       1 
1       1     1     1     1       1 
1       1     1     1     1       1 
1       1     1     1     1       1 
1       1     1     1     1       1 
1       1     1     1     1       1 
1       1     1     1     1       1 
1       1     1     1     1       1 
1       1     1     1     1       1 
1       1     1     1     1       1 
1       1     1     1     1       1 
1       1     1     1     1       1 
4 111 111     1 11111     1 111 114 
                                    
1   1   1     1     1     1   1   1 
1   1   1     1     1     1   1   1 
1   1   1     1     1     1   1   1 
1   1   1     1     1     1   1   1 
1   1   1     1     1     1   1   1 
1   1   1     1     1     1   1   1 
1 111 111 11119     2 11111 111 111 
                                    
    1                         1     
    1                         1     
    1                         1     
    1                         1     
    1                         1     
    1                         1     
    1                         1     
    1                         1     
    1                         1     
    1                         1     
    1                         1     
    1                         1     
    3 111 11111111111111111 113     
                                    
    1   1                 1   1     
    1   1                 1   1     
    1   1                 1   1     
    1   1                 1   1     
1 111 111 111 111111111 111 111 111 
                                    
1           1         1           1 
1           1         1           1 
1           1         1           1 
1           1         1           1 
1           1         1           1 
1           1         1           1 
1 11111111117         1 11111111111 
                                    
1           1         1           1 
1           1         1           1 
1           1         1           1 
1           1         1           1 
1           1         1           1 
1           1         1           1 
1           1 111111111           1 
1                                 1 
1           1         1           1 
1           1         1           1 
1           1         1           1 
1           1         1           1 
1 1111  11111 111111111 1111  11111 
                                    
                                    
                                    
                                    
                                    
                                    
                                    
                                    
                                    
                                    
                                    
*