  1   1    1   1  
  40705    40705  
    1        1    
    1   C    1    
 3006007700706002 
 1     11  1    1 
 1 E   11  1 F  1 
 80000051H 800009 
 1      1  1    1 
 80000006009 G  1 
 1         1    1 
 4070000700607009 
   1    1    1  1 
   1 F  1 G  1  1 
   40070600705  1 
      1    1    1 
      1    800005 
3007009 K  1      
1  1  1    800002 
1  800600009    1 
1  1       1    1 
1  1       1 I  1 
1  1   L   1    1 
800:0000700607005 
1  1    1    1    
1G 1 H  1  G 1    
400:0000:00009    
   1    1    1    
   1    1 E  1    
   800006000060002
   1             1
   1G    F     G 1
300600700007000005
1     1    1      
1H  F 1 G  1      
400700:00706002C  
   1  1  1    1   
   1F 1  1    1   
B  1  1H 1 3009   
   1  1  1 1  1K  
   1G 1  1 1  1   
   400:009 8005   
I     1  1 1      
      1  1 1   D  
300000600:06000002
1        1       1
1F  G  E 1E G  F 1
400007000600700075
     1      1   1 
     1      1   1 
     1E C   1   1 
  300600700060009 
  1     800070005 
  1   F 1   1     
  400700:000600002
     1  1        1
     1G 1E       1
     1  8000070005
  J  1  1    1    
     8006007060002
     1     1     1
     1     1   E 1
  L  1 I   1     1
     4707006007005
      1 1     1   
    30609   H 802 
    1   1B    1 1 
    1E  8000009 1 
    1   1     1 1 
    8007600007605 
    1  1     1    
    1F 1     1    
    1  1 D   1 C  
    8006007006002 
    1     1     1 
    1 F   1 G   1 
300060000060000062
1                1
1G   H  F  H  G  1
407000700070007005
*

        1                 1         
        1                 1         
  1 11111 11111 1 11111 111 11111   
                                    
  1           1 1     1         1   
  1           1 1     1         1   
  1           1 1     1         1   
  1           1 1     1         1   
  1 11111111111 1     1 111111111   
                1                   
  1             1     1         1   
  1             1     1         1   
  4 1111111111111 11111         1   
                                1   
  1                   1         1   
  1                   1         1   
  1 111 111111111 11111 111 11111   
                                    
      1         1         1     1   
      1         1         1     1   
      1         1         1     1   
      1         1         1     1   
      1 11111 112 11111 111     1   
                                1   
            1         1         1   
            1         1         1   
            1         1 111111111   
            1                       
1 11111 11111         1             
                      1             
1     1     1         1 111111111   
1     1     1                       
1     1 11111 111111111         1   
1                               1   
1     1               1         1   
1     1               1         1   
1     1               1         1   
1     1               1         1   
1     1               1         1   
1     1               1         1   
4 11111 111111111 11111 111 11114   
                                    
1     1         1         1         
1     1         1         1         
1     1         1         1         
1     1         1         1         
1 11111 11111111B 111111111         
                                    
      1         1         1         
      1         1         1         
      1         1         1         
      1         1         1         
      1 111111111 111111111 1111111 
                                    
      1                           1 
      1                           1 
      1                           1 
      1                           1 
1 11111 11111 111111111 11111111113 
                                    
1           1         1             
1           1         1             
1           1         1             
1           1         1             
1 11111 11111 11111 118 11111       
                                    
      1     1     1         1       
      1     1     1         1       
      1     1     1         1       
      1     1     1         1       
      1     1     1   1 11111       
      1     1     1                 
      1     1     1   1     1       
      1     1     1   1     1       
      1     1     1   1     1       
      1     1     1   1     1       
      1 11111 11111   1 11111       
                                    
            1     1   1             
            1     1   1             
            1     1   1             
            1     1   1             
1 11111111112 11111 111 11111111111 
                                    
1                 1               1 
1                 1               1 
1                 1               1 
1                 1               1 
1 111111111 1111111 11111 1111111 1 
                                    
          1             1       1   
          1             1       1   
          1             1       1   
          1             1       1   
          1             1       1   
          1             1       1   
    1 11114 11111 1111111 1111111   
                                    
    1           1 1111111 1111111   
    1                               
    1           1       1           
    1           1       1           
    1 11111 11111 1111111 111111111 
                                    
          1     1                 1 
          1     1                 1 
          1     1                 1 
          1     1                 1 
          1     1 111111111 1111111 
          1                         
          1     1         1         
          1     1         1         
          1 11115 11111 11; 1111111 
                                    
          1           1           1 
          1           1           1 
          1           1           1 
          1           1           1 
          1           1           1 
          1           1           1 
          1 1 111 11111 11111 11111 
                                    
            1   1           1       
            1   1           1       
        1 111 111           1 111   
                                    
        1       1           1   1   
        1       1           1   1   
        1       1 11111111111   1   
        1                       1   
        1       1           1   1   
        1       1           1   1   
        1 11113 1 111111111 1 111   
                                    
        1     1           1         
        1     1           1         
        1     1           1         
        1     1           1         
        1     1           1         
        1     1           1         
        1 11113 11111 11117 11111   
                                    
        1           1           1   
        1           1           1   
        1           1           1   
        1           1           1   
1 1111111 11111111111 11111111111 1 
                                    
1                                 1 
1                                 1 
1                                 1 
1                                 1 
1 111 1111111 1111111 1111111 11111 
*