Textures/desert1.bmp
9 0
9 120
0
       30702      
       1 1 1      
       40:05      
         1        
         1 A      
3070000709        
1 1    1 1        
1 1 B  1 1        
806070760:00070002
1   1 1  1   1   1
1   1 1  80009 C 1
4000:06009   1   1
    1    1   80009
    1 A  1   1   1
    1    1   1   1
    80700:00060005
D   1 1  1        
    1 1  1 B      
    47670:0702    
     1 1 1 1 1    
     1 1 1 1 1    
     80:0:0:09    
     1 1 1 1 1 C  
     1 1 1 1 1    
   C 8060:0609    
     1   1   1    
     4700:0075    
      1  1  1     
      800:009     
      1  1  1C    
      1  8009     
  B   8009  1     
      1  1  1     
   300:00:009     
   1  1  1  1 D   
   1  1  1B 1     
   800:006075     
   1  1    1      
   1  80070602    
   1B 1  1   1    
   1  1  1 C 1    
   400:009 309    
      1  809 1    
      1  1 1 1    
      4009 805    
D        809      
      A  1 1      
         1 1      
  3007000:09      
  1  1   1 1      
  1A 1 B 1 802 A  
  1  1   1 1 1    
  800670760:05    
  1   1 1  1      
  1 A 409  1      
  1     1  1      
  800070600:0702  
  1   1    1 1 1  
  802 1 C  1 1 1  
  1 1 1    1 1 1  
  476067070676062 
   1   1 1  1   1 
   40705 1  40705 
     1   1B   1   
    360706007062  
    1  1    1  1  
    1  1 A  1  1  
    800607006075  
    1    1    1   
D   1 B  1 C  1   
307060707600075   
1 1   1 1    1    
1 1   1 1 A  8002 
1 80009 800009  1 
1 1   1 1    8005 
476000:0607009    
 1    1   1  1    
 8000760076709    
 1   1   1 1 1D   
 1   1   1 1 1    
 1D  1 B 809 1    
 407060009 409    
   1     1   1    
   407000:0009    
     1   1   1 C  
     1   1   80002
 3007600760009   1
 1  1   1    1 C 1
 1B 1 A 1    1   1
 47067006007060075
  1  1     1    1 
  1  1 C   1    1 
  470607000607009 
   1   1     1  1 
   1   1 B   1  1 
   80076000706075 
   1  1    1   1  
   1C 1 A  1   1  
   1  1    1   1  
   4706070060709  
    1   1    1 1  
    1   1 B  1 1  
    1   1    809  
  306070600705 1  
  1   1    1   1  
  1   1    1   1  
  80009    80009  
  1   1D   1   1  
  1B  407005 C 1  
  1     1      1  
  1     1      1  
  800000:0700009  
  1     1 1    1  
  1  A  1 1  B 1  
  1  3005 4002 1  
  4009       805  
     4000;0005    
         1        
         1        
         1        
         1        
*
              1 111 111             
                                    
              1   1   1             
              1   1   1             
              1 111 111             
                                    
                  1                 
                  1                 
                  1                 
                  1                 
1 111 111111111 111                 
                                    
1   1         1   1                 
1   1         1   1                 
1   1         1   1                 
1   1         1   1                 
1 111 111 111 1 111 1111111 1111116 
                                    
1       1   1     1       1       1 
1       1   1     1       1       1 
1       1   1     1 1111111       1 
1       1   1                     1 
1 1111111 111 11111       1       1 
                          1       1 
        1         1       1 1111111 
        1         1                 
        1         1       1       1 
        1         1       1       1 
        1         1       1       1 
        1         1       1       1 
        1 111 11112 1111111 1111111 
                                    
        1   1     1                 
        1   1     1                 
        1   1     1                 
        1   1     1                 
        1 5 1 1 111 111 115         
                                    
          1   1   1   1   1         
          1   1   1   1   1         
          1   1   1   1   1         
          1   1   1   1   1         
          1 114 111 114 111         
                                    
          1   1   1   1   1         
          1   1   1   1   1         
          1   1   1   1   1         
          1   1   1   1   1         
          = 114 111 114 11;         
                                    
          1       1       1         
          1       1       1         
          5 1 11117 11111 5         
                                    
            1     1     1           
            1     1     1           
            1 11111 11111           
                                    
            1     1     1           
            1     1     1           
            1     1 11111           
            1                       
            1 11111     1           
                        1           
            1     1     1           
            1     1     1           
      1 11111 11113 11111           
                                    
      1     1     1     1           
      1     1     1     1           
      1     1     1     1           
      1     1     1     1           
      2 11111 11111 111 1           
                                    
      1     1         1             
      1     1         1             
      1     1 11111 111 111         
      1                             
      1     1     1       1         
      1     1     1       1         
      1     1     1       1         
      1     1     1       1         
      4 11111 11111   1 111         
                                    
            1     1 111   1         
            1             1         
            1     1   1   1         
            1     1   1   1         
            1 11111   1 111         
                                    
                  ; 111             
                                    
                  1   1             
                  1   1             
                  1   1             
                  1   1             
    1 11111 1111111 111             
                                    
    1     1       1   1             
    1     1       1   1             
    1     1       1   1 116         
    1     1       1                 
    1     1       1   1   1         
    1     1       1   1   1         
    1 11111 1 111 1 111 111         
                                    
    1       1   1     1             
    1       1   1     1             
    1       1 111     1             
    1                 1             
    1           1     1             
    1           1     1             
    1 1111111 111 11111 111 11=     
                                    
    1       1         1   1   1     
    1       1         1   1   1     
    1 112   1         1   1   1     
            1         1   1   1     
    1   1   1         1   1   1     
    1   1   1         1   1   1     
    1 1 1 111 1 111 111 1 1 111 1   
                                    
      1       1   1     1       1   
      1       1   1     1       1   
      5 111 111   1     1 111 115   
                  1                 
          1       1         1       
          1       1         1       
        1 1 111 111 11111 111 :     
                                    
        1     1         1     1     
        1     1         1     1     
        1     1         1     1     
        1     1         1     1     
        1 11111 118 11111 111 1     
                                    
        1         1         1       
        1         1         1       
        1         1         1       
        1         1         1       
1 111 111 111 111 1 1111111 1       
                                    
1   1       1   1         1         
1   1       1   1         1         
1   1       1   1         1 11115   
1   1       1   1                   
1   1 1111111   1 111111111     1   
1                               1   
1   1       1   1         1 11111   
1   1       1   1                   
6 1 1 1111113 111 111 11111         
                                    
  1         1       1     1         
  1         1       1     1         
  1 1111111 1 11111 1 1 111         
                                    
  1       1       1   1   1         
  1       1       1   1   1         
  1       1       1   1   1         
  1       1       1   1   1         
  1       1       1 111   1         
  1       1               1         
  ; 111 111 1111111   1 111         
                                    
      1           1       1         
      1           1       1         
      1 111 1111111 111111=         
                                    
          1       1       1         
          1       1       1         
          1       1       1 1111114 
          1       1                 
  1 11111 1 11111 1 1111111       1 
                                  1 
  1     1       1         1       1 
  1     1       1         1       1 
  1     1       1         1       1 
  1     1       1         1       1 
  4 1 111 1 11111 11111 111 11111 5 
                                    
    1     1           1         1   
    1     1           1         1   
    1     1           1         1   
    1     1           1         1   
    1 1 111 111 1111111 112 11111   
                                    
      1       1           1     1   
      1       1           1     1   
      1       1           1     1   
      1       1           1     1   
      6 11111 1 1111111 111 111 4   
                                    
      1     1         1       1     
      1     1         1       1     
      1     1         1       1     
      1     1         1       1     
      1     1         1       1     
      1     1         1       1     
      1 1 111 111 11111 111 111     
                                    
        1       1         1   1     
        1       1         1   1     
        1       1         1   1     
        1       1         1   1     
        1       1         1 111     
        1       1                   
    7 111 111 111 11111 111   1     
                              1     
    1       1         1       1     
    1       1         1       1     
    1       1         1       1     
    1       1         1       1     
    1 1111111         1 1111111     
                                    
    1       1         1       1     
    1       1         1       1     
    1       1 111 11111       1     
    1                         1     
    1           1             1     
    1           1             1     
    1           1             1     
    1           1             1     
    1 11111111111 111 111111116     
                                    
    1           1   1         1     
    1           1   1         1     
    1           1   1         1     
    1           1   1         1     
    1     1 11114   4 11111   1     
    1                         1     
    1 11111               1 111     
                                    
          1 111111  1111111         
                                    
                                    
                                    
                                    
                                    
                                    
                                    
                                    
                                    
*