Textures/garden1.bmp
7 7
10 10
0
300000070070000002
1      1  1      1
1Y Z [ 1D 1Y Z [ 1
4000000:00:0000005
       1  1       
 C   B 1G 1B    C 
       1  1       
30070005  40007002
1  1          1  1
1\ 1E   \   F 1\ 1
80060002  30006009
1      1  1      1
400002 1  1 300005
     1 1H 1 1     
  B  40:00:05 C   
       1  1       
       1  1       
       4005       
*
2 1111111111114 11113 1111111111112 
                                    
1             1     1             1 
1             1     1             1 
1             1     1             1 
1             1     1             1 
1 1111111111111 11111 1111111111111 
                                    
              1     1               
              1     1               
              1     1               
              1     1               
              1     1               
              1     1               
6 11111 1111111     = 1111111 11116 
                                    
1     1                     1     1 
1     1                     1     1 
1     1                     1     1 
1     1                     1     1 
1 11111 111111:     1 1111111 11111 
                                    
1             1     1             1 
1             1     1             1 
1 111111112   1     1   2 111111111 
              1     1               
          1   1     1   1           
          1   1     1   1           
          1 111 11111 111           
                                    
              1     1               
              1     1               
              1     1               
              1     1               
              3 11114               
                                    
*