Textures/desert1.bmp
8 0
8 115
0
       302        
       1 1        
       475        
        1         
     3006002      
 30009     80002  
 1   1     1   1  
 1   1     1   1  
 1   1 D   1 C 1  
 1   1     1   1  
 1 B 4007005   1  
 1      1      1  
 4070000:0000705  
   1    1    1    
   1 C  1 B  1    
   1    1    1    
3005 300:002 4002 
1    1  1  1    1 
1    1  1  1    1 
40070607670607005 
   1   1 1   1    
   1 A 1 1   1    
3005   1 1   4002 
1      1 1      1 
1   3005 4002   1 
1   1       1   1 
1   407070705 B 1 
1     1 1 1     1 
4000075 1 4700005 
     1  1  1      
  C  1  1  1A     
     1  1  1      
300005  1  400002 
1       1       1 
1     30:02     1 
40002 1 1 1 30005 
    1 40:05 1     
    1   1   1  B  
    4070:0705     
 C    1 1 1       
      1 1 1       
30070760:06707002 
1  1 1  1  1 1  1 
1  405  1  405A 1 
1B      1       1 
40000700:00700005 
     1  1  1      
 302 1  1  1 302B 
 1 1 1C 1  1 1 1  
 1 1 1  1  1 1 1  
36060600:00606062 
1       1       1 
1  302  1  302  1 
8005 400:005 4009 
1       1       1 
8002 307:702 3009 
1  405 111 405  1 
1     35142     1 
1     1 1 1   C 1 
1B  305 1 402   1 
80009   1   80009 
1   1   1   1   1 
1   1 30:02 1   1 
40705 1 1 1 40705 
  1   1 1 1   1   
  1 305 1 402 1   
  1 1   1   1 1   
309 1   1   1 802 
1 1 407060705 1 1 
1 1   1   1   1 1 
1 802 1 A 1 309 1 
1 1 1 1   1 1 1 1 
1 1 1 1   1 1 1 1 
805 409   805 409 
1     1 B 1     1 
1     1   1     1 
1     1   1     1 
4007005   4007005 
   1   C     1    
   1  30002  1    
   1  1   1  1 C  
B  1  1   1  1    
   47060706075    
    1   1   1     
  309   1   802   
  1 1   1   1 1   
309 1   1   1 802 
1 1 4070:0705 1 1 
1 1   1 1 1   1 1 
1 1   1 1 1 B 1 1 
4060705 1 4070605 
    1   1   1     
    1   1   1     
 3009 A 1   8002  
 1  1   1   1  1  
 1  4000:0005  1  
 1C     1      1  
 1    30:02    1  
 8002 1 1 1 3009  
 1  1 40:05 1  1  
 1  1   1   1  1  
 1  1A  1   1  1  
 1  1   1 B 1  1  
 1  1   1   1  1  
 1  1   1   1  1  
 1  4000:0005  1  
 1      1      1  
 8000000:0000009  
 1      1      1  
 1 30000600002 1  
 1 1         1 1  
 4060000;0000605  
        1         
        1         
        1         
    D   1D        
*
              1 111                 
                                    
              1   1                 
              1   1                 
              1 1 1                 
                                    
                1                   
                1                   
          1 11111 11111             
                                    
  1 1111111           1 1111111     
                                    
  1       1           1       1     
  1       1           1       1     
  1       1           1       1     
  1       1           1       1     
  1       1           1       1     
  1       1           1       1     
  1       1           1       1     
  1       1           1       1     
  1       4 11111 11114       1     
  1                           1     
  1             1             1     
  1             1             1     
  2 111 111111111 111111111 112     
                                    
      1         1         1         
      1         1         1         
      1         1         1         
      1         1         1         
      1         1         1         
      1         1         1         
1 11111   5 11111 11115   1 11111   
                                    
1         1     1     1         1   
1         1     1     1         1   
1         1     1     1         1   
1         1     1     1         1   
1 11111 111 111 1 1 111 111 11111   
                                    
      1       1   1       1         
      1       1   1       1         
      1       1   1       1         
      1       1   1       1         
5 11111       1   1       1 11115   
              1   1                 
1             1   1             1   
1             1   1             1   
1       4 11111   1 11114       1   
1                               1   
1       1               1       1   
1       1               1       1   
1       1 111 11; 111 111       1   
1                               1   
1           1   1   1           1   
1           1   1   1           1   
6 111111111 1   1   1 1 111111116   
                1                   
          1     1     1             
          1     1     1             
          1     1     1             
          1     1     1             
          1     1     1             
          1     1     1             
2 111111111     1     1 111111112   
                1                   
1               1               1   
1               1               1   
1           4 117 115           1   
1                               1   
1 1111111   1   1   1   1 1111111   
            1   1   1               
        1   5 111 114   1           
        1               1           
        1       1       1           
        1       1       1           
        1 111 111 111 111           
                                    
            1   1   1               
            1   1   1               
            1   1   1               
            1   1   1               
= 11111 111 1 111 111 1 111 1111;   
                                    
1     1   1     1     1   1     1   
1     1   1     1     1   1     1   
1     1 161     1     1 611     1   
1               1               1   
1               1               1   
1               1               1   
1 111111111 11111 11111 111111111   
                                    
          1     1     1             
          1     1     1             
  8 115   1     1     1   5 117     
          1     1     1             
  1   1   1     1     1   1   1     
  1   1   1     1     1   1   1     
  1   1   1     1     1   1   1     
  1   1   1     1     1   1   1     
1 1 111 111 11111 11111 111 111 1   
                                    
1               1               1   
1               1               1   
1     1 111     1     1 111     1   
1               1               1   
2 11111   1 11113 11111   1 11112   
                                    
1               1               1   
1               1               1   
1 11111   1 111 1 1 111   1 11111   
                                    
1     4 111   1 1 1   1 114     1   
1             1 1 1             1   
1           1 1 1 1 1           1   
1               1               1   
1           1   1   1           1   
1           1   1   1           1   
1       1 111   1   1 111       1   
1               1               1   
1 1111111       1       1 1111111   
                1                   
1       1       1       1       1   
1       1       1       1       1   
1       1   1 117 111   1       1   
1       1               1       1   
1 11; 111   1   1   1   1 11; 111   
            1   1   1               
    1       1   1   1       1       
    1       1   1   1       1       
    1   5 111   1   1 115   1       
    1           1           1       
    1   1       1       1   1       
    1   1       1       1   1       
6 111   1       1       1   1 116   
        1       1       1           
1   1   1 111 111 111 111   1   1   
1   1                       1   1   
1   1       1       1       1   1   
1   1       1       1       1   1   
1   1 118   1       1   8 111   1   
1           1       1           1   
1   1   1   1       1   1   1   1   
1   1   1   1       1   1   1   1   
1   1   1   1       1   1   1   1   
1   1   1   1       1   1   1   1   
1 111   1 111       1 111   1 111   
                                    
1           1       1           1   
1           1       1           1   
1           1       1           1   
1           1       1           1   
1           1       1           1   
1           1       1           1   
1 11111 11112       2 11111 11111   
                                    
      1                   1         
      1                   1         
      1     1 1111111     1         
      1                   1         
      1     1       1     1         
      1     1       1     1         
      1     1       1     1         
      1     1       1     1         
      1 1 111 11= 111 111 1         
                                    
        1       1       1           
        1       1       1           
    1 111       1       1 111       
                1                   
    1   1       1       1   1       
    1   1       1       1   1       
6 111   1       1       1   1 116   
        1       1       1           
1   1   1 115 111 115 111   1   1   
1   1                       1   1   
1   1       1   1   1       1   1   
1   1       1   1   1       1   1   
1   1       1   1   1       1   1   
1   1       1   1   1       1   1   
2 111 111 111   1   1 111 111 112   
                1                   
        1       1       1           
        1       1       1           
        1       1       1           
        1       1       1           
  8 11111       1       1 11117     
                1                   
  1     1       1       1     1     
  1     1       1       1     1     
  1     1 111111; 1111111     1     
  1                           1     
  1             1             1     
  1             1             1     
  1         4 111 111         1     
  1                           1     
  6 11111   1   1   1   1 11116     
            1   1   1               
  1     1   1 111 116   1     1     
  1     1               1     1     
  1     1       1       1     1     
  1     1       1       1     1     
  1     1       1       1     1     
  1     1       1       1     1     
  1     1       1       1     1     
  1     1       1       1     1     
  5     1       1       1     5     
  1     1       1       1     1     
  1     1       1       1     1     
  1     1       1       1     1     
  1     1 1111111 1111111     1     
  1                           1     
  1             1             1     
  1             1             1     
  4 1111111111111 1111111111114     
                                    
  1             1             1     
  1             1             1     
  1   1 111111111 111111111   1     
  1                           1     
  1   1                   1   1     
  1   1                   1   1     
  1 111 11111111  111111111 111     
                                    
                                    
                                    
                                    
                                    
                                    
                                    
                                    
                                    
*