Textures/classic.bmp
7 2
11 79
0
3000000002        
1        80000002 
4000000705      1 
   3000:000000009 
 305   1   3002 1 
 1     1   1  1 1 
 1 3000:0005  475 
 1 1   1       1  
 40:000:000702 1  
   1   1   1 1 1  
   1   1   1 1 1  
   40006000:0609  
 300002    1   1  
 1    1    1   1  
 1 300:0000:0005  
 809  1    1      
 1 1  1    1      
 1 400:0000:000002
 40700:0000:002  1
   1  1    1  4005
   1  1    1      
   1  1    1      
   1  1    1      
   800607005      
   1    1         
   1    1         
   1    1         
30060000:000000002
1       1        1
1       1        1
1       1        1
400700009        1
   13000:000000009
   11   1        1
   11   8000000009
   11   1        1
   1800060002    1
   11      3:00009
   4:00000051    1
    1       1    1
    80000700:00009
    1    1  1    1
    1    1  1    1
3000:00009  1    1
1   1    1  1    1
802 1    4009    1
1 409       800009
1   1       1    1
1   1       1    1
8070:0007000600009
1 1 1   1        1
1 1 1   1        1
1 1 1   1        1
1 1 1   8000070009
406060009    1   1
        1    1   1
 3002   1    1   1
 1  1   1    1   1
 1  8000:0000:0005
 1  1   1    1    
 1  1   1    1    
 4006000:00006702 
        1     1 1 
        42    1 1 
   30000760000:09 
   1    1     1 1 
   1    1     1 1 
   40700:000709 1 
     1  1   1 1 1 
     1  1   1 1 1 
     1  400060:05 
     1        1   
     1        1   
     4007000009   
        1     1   
        1     1   
        400;005   
           1      
           1      
           1      
*
5 11111111111111111                 
                                    
1                 1 1111111111111   
1                                   
1 1111111111111 111             1   
                                1   
      1 1111111 11111111111111111   
                                    
  1 111       1       1 11111   1   
              1                 1   
  1           1       1     1   1   
  1           1       1     1   1   
  1   1 1111111 1111111     1 1 1   
  1                                 
  1   1       1               1     
  1   1       1               1     
  1 111 1111111 1111111 111   1     
                              1     
      1       1       1   1   1     
      1       1       1   1   1     
      1       1       1   1   1     
      1       1       1   1   1     
      2 1111111 1111111 111 114     
                                    
  1 111111111         1       1     
                      1       1     
  1         1         1       1     
  1         1         1       1     
  1   7 11111 111111111 1111111     
  1                                 
  1 111     1         1             
            1         1             
  1   1     1         1             
  1   1     1         1             
  1   1 11111 111111111 11111111111 
  1                                 
  1 111 11111 111111111 11111     1 
                                  1 
      1     1         1     1 11112 
      1     1         1             
      1     1         1             
      1     1         1             
      1     1         1             
      1     1         1             
      1     1         1             
      1     1         1             
      1 11111 111 11116             
                                    
      1         1                   
      1         1                   
      1         1                   
      1         1                   
      1         1                   
      1         1                   
2 11111 111111111 11111111111111119 
                                    
1               1                 1 
1               1                 1 
1               1                 1 
1               1                 1 
1               1                 1 
1               1                 1 
3 11111 111111111                 1 
                                  1 
      1 1 1111111 11111111111111113 
      1                             
      1 1       1                 1 
      1 1       1                 1 
      1 1       1 11111111111111111 
      1 1                           
      1 1       1                 1 
      1 1       1                 1 
      1 1 1111111 1111111         1 
      1                           1 
      1 1             1 1 111111111 
      1 1                           
      8 1 1111111111111 1         1 
                        1         1 
        1               1         1 
        1               1         1 
        1 111111111 11111 111111111 
                                    
        1         1     1         1 
        1         1     1         1 
        1         1     1         1 
        1         1     1         1 
2 1111111 111111111     1         1 
                        1         1 
1       1         1     1         1 
1       1         1     1         1 
1 111   1         1 11111         1 
        1                         1 
1   1 111               1 11111111: 
1                                   
1       1               1         1 
1       1               1         1 
1       1               1         1 
1       1               1         1 
1 111 111 1111118 1111111 111111111 
                                    
1   1   1       1                 1 
1   1   1       1                 1 
1   1   1       1                 1 
1   1   1       1                 1 
1   1   1       1                 1 
1   1   1       1                 1 
1   1   1       1 111111111 1111111 
1   1   1                           
5 111 111 1111111         1       1 
                          1       1 
                1         1       1 
                1         1       1 
  2 11111       1         1       1 
                1         1       1 
  1     1       1         1       1 
  1     1       1         1       1 
  1     1 1111111 111111111 1111112 
  1                                 
  1     1       1         1         
  1     1       1         1         
  1     1       1         1         
  1     1       1         1         
  1 11111 1141111 111111111 1 111   
                                    
                1           1   1   
                1           1   1   
                1 1         1   1   
                            1   1   
      1 111111111 1 111111111 111   
                                    
      1         1           1   1   
      1         1           1   1   
      1         1           1   1   
      1         1           1   1   
      2 111 11111 1111111 111   1   
                                1   
          1     1       1   1   1   
          1     1       1   1   1   
          1     1       1   1   1   
          1     1       1   1   1   
          1     1 1111111 111 117   
          1                         
          1                 1       
          1                 1       
          1                 1       
          1                 1       
          1 11111 11111111111       
                                    
                1           1       
                1           1       
                1           1       
                1           1       
                1 1111  11111       
                                    
                                    
                                    
                                    
                                    
                                    
                                    
*