Textures/classic5.bmp
8 0
10 111
0
      30702       
      1 1 1       
300000:0:0:0000002
1     1 1 1      1
1     1 1 1      1
1  3005 1 4002   1
1  1    1    1   1
1  1    1    1   1
470600076700060075
 1     1 1      1 
 1     1 1      1 
 1     1 1      1 
 8000705 40700009 
 1   1     1    1 
 1   1     1    1 
 1 306007006002 1 
 1 1    1     1 1 
 1 1 30060002 1 1 
 1 1 1      1 1 1 
 1 1 40070005 1 1 
 1 1    1     1 1 
 1 407076007075 1 
 1   1 1   1 1  1 
 4070606000606705 
   1     300009   
   1     1    1   
   8000005    1   
   407000700705   
     1   1  1     
     80009  1     
     1   8009     
     1   1  1     
 30075   1  40702 
 1  1    1    1 1 
 1  1  30:02  1 1 
 1  1  1 1 1  1 1 
 8009  1 1 1  809 
 1  1  1 1 1  1 1 
 1  1  1 1 1  1 1 
 1  80060606009 1 
 8009         809 
 1  1         1 1 
 47060700700705 1 
  1   1  1  1   42
  1   1  1  1    1
  1   1  1  1    1
 3607062 1 3607009
 1  1  80:09  1  1
 1  1  1 1 1  1  1
 800:009 1 800:009
 1  1  1 1 1  1  1
 1  1  87:79  1  1
 40060051114006005
        111       
        111       
300000006:60000002
1        1       1
1   30000:00002  1
1   1    1    1  1
1   1    1    1  1
80705 300:002 4009
1 1   1  1  1    1
1 1   1  1  1    1
1 4070600:00600709
1   1    1     1 1
80009    1     1 1
1   40000:000005 1
1        1       1
407070000607000009
  1 1      1     1
  1 1      1     1
305 402    402 305
1     1      1 1  
1     1      1 1  
407000600700060602
  1      1       1
  1 30000:0002   1
  1 42   1  35 309
  1 35   1  42 1 1
  1 42   1  35 1 1
  1 35   1  42 1 1
  1 42   1  35 1 1
  8006070600:00609
  1    1    1    1
  1    1    1    1
  1    1    1    1
  1    1    1    1
  4070060070600705
    1     1    1  
    1     1    1  
    4007005  305  
       1     1    
       1     1    
    300600700602  
    1     1    1  
    1     1    1  
30009     1    802
1   1     1    1 1
1   1 3000:00021 1
1   1 1   1   85 1
1   1 1   1   1  1
8000:05   1   1  1
1   1     1   8009
1   400000:0005  1
1         1      1
407000070060700075
  1    1    1   1 
  1    1    1   1 
  40000600;060005 
          1       
          1       
          1       
*
            1 111 111               
                                    
            1   1   1               
            1   1   1               
1 11111111111 111 111 1111111111111 
                                    
1           1   1   1             1 
1           1   1   1             1 
1           1   1   1             1 
1           1   1   1             1 
1     1 11111   1   1 11111       1 
1               1                 1 
1     1         1         1       1 
1     1         1         1       1 
1     1         1         1       1 
1     1         1         1       1 
2 1 111 1111111 1 1 1111111 11111 1 
                                    
  1           1   1             1   
  1           1   1             1   
  1           1   1             1   
  1           1   1             1   
  1           1   1             1   
  1           1   1             1   
  1 1111111 113   3 111 111111111   
                                    
  1       1           1         1   
  1       1           1         1   
  1       1           1         1   
  1       1           1         1   
  1   1 111 11111 11111 11111   1   
  1                             1   
  1   1         1           1   1   
  1   1         1           1   1   
  1   1   1 11111 1111116   1   1   
  1   1                     1   1   
  1   1   1             1   1   1   
  1   1   1             1   1   1   
  1   1   9 11111 1111111   1   1   
  1   1                     1   1   
  1   1         1           1   1   
  1   1         1           1   1   
  1   1 111 111 1 11111 111 1   1   
  1                             1   
  1       1   1       1   1     1   
  1       1   1       1   1     1   
  4 111 111 111 1111111 111 1 115   
                                    
      1           1 111111111       
      1                             
      1           1         1       
      1           1         1       
      1 11111111111         1       
                            1       
      1 111 1111111 11111 111       
                                    
          1       1     1           
          1       1     1           
          1 1111111     1           
                        1           
          1       1 11111           
          1                         
          1       1     1           
          1       1     1           
  2 11111 1       1     8 111 111   
                  1                 
  1     1         1         1   1   
  1     1         1         1   1   
  1     1     1 111 111     1   1   
  1     1                   1   1   
  1     1     1   1   1     1   1   
  1     1     1   1   1     1   1   
  1 11111     1   1   1     1 11:   
              1   1   1             
  1     1     1   1   1     1   1   
  1     1     1   1   1     1   1   
  1     1     1   1   1     1   1   
  1     1     1   1   1     1   1   
  1     1 11111 111 111 11111   1   
  1                             1   
  4 11111                   5 111   
                                    
  1     1                   1   1   
  1     1                   1   1   
  1 1 111 111 11111 11111 111   1   
                                1   
    1       1     1     1       1 1 
    1       1     1     1           
    1       1     1     1         1 
    1       1     1     1         1 
    1       1     1     1         1 
    1       1     1     1         1 
  7 1 111 111 1   1   1 1 111 11111 
                  1                 
  1     1     1 111 111     1     1 
  1     1                   1     1 
  1     1     1   1   1     1     1 
  1     1     1   1   1     1     1 
  1 11111 11111   1   1 11111 11111 
                  1                 
  1     1     1   1   1     1     1 
  1     1     1   1   1     1     1 
  1     1     1 1 1 1 1     1     1 
  1     1                   1     1 
  6 11111 11111 1 1 1 1 11111 11113 
                1 1 1               
                1 1 1               
                1 1 1               
                1 1 1               
                1 1 1               
2 111111111111111 1 1 111111111111: 
                                    
1                 1               1 
1                 1               1 
1       3 111111111 111111115     1 
1                                 1 
1       1         1         1     1 
1       1         1         1     1 
1       1         1         1     1 
1       1         1         1     1 
1 111 111   1 11111 11111   1 11111 
                                    
1   1       1     1     1         1 
1   1       1     1     1         1 
1   1       1     1     1         1 
1   1       1     1     1         1 
1   1 111 111 11111 11111 11111 111 
1                                   
1       1         1           1   1 
1       1         1           1   1 
1 1111111         1           1   1 
                  1           1   1 
1       1 111111119 11111111111   1 
1                                 1 
1                 1               1 
1                 1               1 
3 111 111 111111111 111 11111111111 
                                    
    1   1             1           1 
    1   1             1           1 
    1   1             1           1 
    1   1             1           1 
1 111   1 111         1 111   1 116 
                                    
1           1             1   1     
1           1             1   1     
1           1             1   1     
1           1             1   1     
1 111 1111111 11111 1111111 111 111 
                                    
    1             1               1 
    1             1               1 
    1   1 111111111 1111111       1 
    1                             1 
    1   1 1       1     1 1   1 111 
    1             1                 
    1   6 1       1     1 3   1   1 
    1             1           1   1 
    2   7 1       9     1 :   1   1 
    1             1           1   2 
    1   4 1       1     1 5   1   1 
    1             1           1   1 
    1   1 1       1     1 1   1   1 
    1             1           1   1 
    1 11111 111 111 11111 11111 111 
                                    
    1         1         1         1 
    1         1         1         1 
    1         1         1         1 
    1         1         1         1 
    1         1         1         1 
    1         1         1         1 
    1         1         1         1 
    1         1         1         1 
    1 111 11111 11111 111 11111 111 
                                    
        1           1         1     
        1           1         1     
        1           1         1     
        1           1         1     
        1 11111 11111     1 111     
                                    
              1           1         
              1           1         
              1           1         
              1           1         
        2 11111 11111 11111 111     
                                    
        1           1         1     
        1           1         1     
        1           1         1     
        1           1         1     
4 1111111           1         1 115 
                    1               
1       1           1         1   1 
1       1           1         1   1 
1       1   1 1111111 1111111 1   1 
1       1                     1   1 
1       1   1       1       1 1   1 
1       1   1       1             1 
1       1   1       1       1     1 
1       1   1       1       1     1 
1 1111111 111       1       1     1 
                    1       1     1 
1       1           1       1 11111 
1       1           1               
1       1 11111111111 1111111     1 
1                                 1 
1                   1             1 
1                   1             1 
1 111 111111111 11111 111 1111111 2 
                                    
    1         1         1       1   
    1         1         1       1   
    1         1         1       1   
    1         1         1       1   
    1 111111111 1111  111 1111111   
                                    
                                    
                                    
                                    
                                    
                                    
                                    
*