Textures/desert2.bmp
6 0
7 117
0
      3002        
   3005  4002     
   1        1     
   1 A   B  1     
   1        1     
   4700000075     
    1      1      
    1      1      
    1      1      
30005 D    40002  
1              1  
8000002  3000009  
1     1  1     1  
1     1  1 B   1  
802   8009   309  
1 1C  1  1   1 1  
1 1   1  1   1 1  
1 80005  40009 1  
1 1          1 1  
409          805  
  40002  30005    
      1  1        
      1  1        
      8009        
  D   1  1D       
   3005  4002     
   1        1     
3009 A      8002  
1  1      B 1  1  
1  4070000705  1  
1    1    1    1  
8002 1    1 3009  
1  1 1    1 1  1  
1  1 1D   1 1  1  
1  1 1    1 1  1  
1  475 C  475  1  
1   1      1   1  
40705      40705  
  1      A   1    
  1  B       1    
  407070070705    
    1 1  1 1      
    1 1  1 1      
302 1 1B 1 1 302  
1 805 1  1 409 1  
475   1  1   475  
 1    1  1C   1   
 400705  407005   
    1      1      
30009      80002  
1   40700705   1  
1     1  1     1  
1     1  1     1  
1 30005  40002 1  
1 1          1 1  
1 1          1 1  
475        B 475  
 1    D       1   
 1            1   
 400002  300005   
      8009        
 300005  400002   
 1            1   
 1 B     A    1   
 402        305   
   8002  3009     
   1  1  1  1C    
3009  1  1  8002  
1  1  8009  1  1  
8005  1  1  4009  
1     1  1     1  
1   A 1  1     1  
4700705  4070075  
 1  1      1  1   
35  1  C   1  42  
1   1      1   1  
1   80023009   1  
1   1  11  1   1  
1   1  11  1   1  
1 C 80054009 B 1  
1   1      1   1  
40705      40705  
  1          1    
  1    A     1    
  1          1    
  470700007075    
   1 1    1 1     
   1 1    1 1     
   1 1    1 1     
   1 1D   1 1     
   1 400005 1     
   1        1     
   4070000705     
     1    1       
     1A   1       
300009    800002  
1    1    1    1  
1    1    1    1  
400009 B  800005  
     1    1       
300709    807002  
1  1 1    1 1  1  
1  1 1  C 1 1  1  
1  1 470075 1A 1  
1  1  1  1  1  1  
1  1  1  1  1  1  
1  4009  8005  1  
1     1  1     1  
1 B   1  1     1  
4000075  4700005  
     1    1       
     1    1 C     
 A   1    1       
     1D   1       
     40;005       
       1          
       1          
       1          
*
            1 11111                 
                                    
      1 11111     1 11111           
                                    
      1                 1           
      1                 1           
      1                 1           
      1                 1           
      1                 1           
      1                 1           
      1 1 1111111111111 1           
                                    
        1             1             
        1             1             
        1             1             
        1             1             
        1             1             
        1             1             
1 111111:             = 1111111     
                                    
1                             1     
1                             1     
1 11111111111     1 11111111111     
                                    
1           1     1           1     
1           1     1           1     
1           1     1           1     
1           1     1           1     
4 111       1 11111       1 114     
                                    
1   1       1     1       1   1     
1   1       1     1       1   1     
1   1       1     1       1   1     
1   1       1     1       1   1     
1   1 1111111     1 1111111   1     
1                             1     
1   1                     1   1     
1   1                     1   1     
1 111                     1 111     
                                    
    6 1111118     7 1111116         
                                    
            1     1                 
            1     1                 
            1     1                 
            1     1                 
            1 11111                 
                                    
            1     1                 
            1     1                 
      1 11111     1 11111           
                                    
      1                 1           
      1                 1           
2 11111                 1 11112     
                                    
1     1                 1     1     
1     1                 1     1     
1     1 111 111111111 111     1     
1                             1     
1         1         1         1     
1         1         1         1     
1 11111   1         1   1 11111     
          1         1               
1     1   1         1   1     1     
1     1   1         1   1     1     
1     1   1         1   1     1     
1     1   1         1   1     1     
1     1   1         1   1     1     
1     1   1         1   1     1     
1     1 5 1         1 5 1     1     
1                             1     
1       1             1       1     
1       1             1       1     
6 111 111             1 111 116     
                                    
    1                     1         
    1                     1         
    1                     1         
    1                     1         
    1 111 111 11111 111 111         
                                    
        1   1     1   1             
        1   1     1   1             
        1   1     1   1             
        1   1     1   1             
: 117   1   1     1   1   = 118     
        1   1     1   1             
1   1 111   1     1   1 111   1     
1           1     1           1     
4 1 6       1     1       6 1 4     
            1     1                 
  1         1     1         1       
  1         1     1         1       
  1 11111 111     1 111 11111       
                                    
        1             1             
        1             1             
3 1111111             1 1111113     
                                    
1       2 111 11111 112       1     
1                             1     
1           1     1           1     
1           1     1           1     
1           1     1           1     
1           1     1           1     
1   5 1111111     1 1111115   1     
1                             1     
1   1                     1   1     
1   1                     1   1     
1   1                     1   1     
1   1                     1   1     
1 : 1                     1 = 1     
                                    
  1                         1       
  1                         1       
  1                         1       
  1                         1       
  1 111111111     1 111111111       
                                    
            1 11111                 
                                    
  4 111111111     1 111111114       
                                    
  1                         1       
  1                         1       
  1                         1       
  1                         1       
  1 111                 1 111       
                                    
      1 11112     2 11111           
                                    
      1     1     1     1           
      1     1     1     1           
3 11111     1     1     1 11113     
            1     1                 
1     1     1 11111     1     1     
1     1                 1     1     
1 11111     1     1     1 11111     
            1     1                 
1           1     1           1     
1           1     1           1     
1           1     1           1     
1           1     1           1     
1 1 11111 111     1 111 11111 1     
                                    
  1     1             1     1       
  1     1             1     1       
1 1     1             1     1 1     
        1             1             
1       1             1       1     
1       1             1       1     
1       4 11111 1 11114       1     
7                             7     
1       1     1 1     1       1     
1       1     1 1     1       1     
1       1     1 1     1       1     
1       1     1 1     1       1     
1       6 11111 1 11116       1     
1                             1     
1       1             1       1     
1       1             1       1     
1 111 111             1 111 111     
                                    
    1                     1         
    1                     1         
    1                     1         
    1                     1         
    1                     1         
    1                     1         
    1 1 115 111111114 112 1         
                                    
      1   1         1   1           
      1   1         1   1           
      1   1         1   1           
      1   1         1   1           
      1   1         1   1           
      1   1         1   1           
      1   1         1   1           
      1   1         1   1           
      1   4 111181115   1           
      1                 1           
      1                 1           
      1                 1           
      2 111 111111111 111           
                                    
          1         1               
          1         1               
          1         1               
          1         1               
5 111111111         1 111111114     
                                    
1         1         1         1     
1         1         1         1     
1         1         1         1     
1         1         1         1     
4 111111111         1 111111115     
                                    
          1         1               
          1         1               
: 11111 111         1 111 1111=     
                                    
1     1   1         1   1     1     
1     1   1         1   1     1     
1     1   1         1   1     1     
1     1   1         1   1     1     
1     1   1 1 11111 1   1     1     
1     1                 1     1     
1     1     1     1     1     1     
1     1     1     1     1     1     
1     1     1     1     1     1     
1     1     1     1     1     1     
1     1 11111     1 11111     1     
1                             1     
1           1     1           1     
1           1     1           1     
1           1     1           1     
1           1     1           1     
6 111111111 1     1 1 111111116     
                                    
          1         1               
          1         1               
          1         1               
          1         1               
          1         1               
          1         1               
          1         1               
          1         1               
          1 11  11111               
                                    
                                    
                                    
                                    
                                    
                                    
                                    
*